White,Black,AIAN,Asian,NHPI,Other race alone,Two or more races,total_pop,total_true
1,0,0,0,0,0,1,2,1
45,0,0,0,0,0,0,45,0
51,4,0,0,0,0,0,55,0
48,0,0,0,0,0,0,48,0
51,0,0,0,0,0,4,55,0
55,0,0,1,0,1,0,57,0
43,2,0,0,0,0,1,46,0
51,0,0,1,0,0,1,53,1
50,0,0,1,0,0,0,51,0
59,0,0,0,0,0,1,60,0
52,2,0,0,0,0,0,54,0
47,0,0,0,0,0,1,48,0
46,0,0,0,0,0,0,46,0
56,2,0,0,0,2,0,60,0
79,1,0,0,0,0,2,82,0
76,0,0,0,0,0,0,76,0
64,0,0,1,0,0,2,67,0
166,3,0,4,0,0,2,175,0
57,4,0,0,0,0,3,64,0
57,0,0,0,0,0,0,57,0
96,0,0,0,0,1,0,97,0
135,8,0,2,0,0,0,145,0
83,0,0,0,0,0,0,83,0
73,0,0,0,0,0,1,74,0
134,3,0,15,0,0,2,154,0
101,0,0,0,0,0,1,102,0
78,0,0,1,0,2,0,81,0
49,0,0,1,0,0,0,50,0
56,0,2,1,0,3,3,65,1
56,1,0,0,0,0,2,59,0
38,2,0,1,0,0,0,41,1
41,1,0,2,0,0,2,46,0
57,0,0,1,0,0,0,58,1
56,0,0,0,0,0,0,56,0
51,0,0,0,0,0,0,51,0
62,0,0,0,0,2,0,64,0
51,0,0,0,0,1,1,53,0
53,0,0,0,0,0,1,54,1
49,2,0,0,0,0,0,51,0
90,1,0,2,0,0,1,94,0
13,0,0,1,0,0,0,14,0
48,0,0,0,0,0,1,49,0
22,0,0,0,0,0,1,23,0
12,0,0,0,0,0,0,12,0
39,0,0,0,0,0,0,39,0
72,0,0,0,0,0,0,72,0
29,0,0,0,0,0,0,29,0
25,0,0,0,0,0,0,25,0
47,0,0,1,0,0,0,48,0
43,0,0,0,0,0,0,43,0
55,0,0,0,0,0,0,55,0
49,0,0,0,0,0,0,49,0
36,0,0,0,0,0,0,36,0
57,2,0,0,0,0,1,60,0
60,0,0,0,0,1,0,61,0
47,2,0,0,0,0,1,50,0
89,0,0,1,0,0,2,92,0
82,0,0,0,0,2,1,85,0
27,0,0,0,0,0,0,27,0
82,0,0,0,0,0,0,82,0
48,4,0,0,0,0,3,55,0
80,1,0,1,0,0,1,83,1
49,0,0,0,0,0,0,49,0
80,0,0,2,0,0,0,82,0
23,0,0,2,0,0,0,25,0
91,1,0,3,0,0,0,95,1
107,0,0,2,0,0,5,114,0
101,0,0,1,0,1,0,103,0
49,0,0,0,0,0,0,49,0
81,0,0,2,0,0,0,83,0
179,4,0,2,0,0,6,191,0
209,0,0,3,0,0,5,217,0
31,0,0,0,0,0,0,31,0
1,0,0,0,1,0,0,2,0
45,0,0,0,0,0,0,45,0
60,0,0,0,0,0,0,60,0
81,2,0,2,0,0,3,88,0
33,0,0,0,0,0,0,33,0
105,2,2,4,0,0,5,118,0
76,3,0,0,0,0,1,80,0
42,3,0,2,0,0,5,52,0
54,3,0,0,0,0,0,57,0
57,0,0,0,0,0,0,57,0
48,0,0,0,0,0,0,48,0
48,1,0,0,0,1,0,50,0
44,2,0,0,0,0,2,48,0
48,0,0,0,0,0,0,48,0
67,2,0,3,0,0,2,74,0
72,2,0,1,0,1,1,77,2
53,4,0,0,0,0,0,57,0
85,3,0,0,0,0,1,89,0
12,0,0,2,0,0,0,14,0
76,1,0,0,0,2,1,80,0
33,0,0,0,0,0,1,34,0
59,1,1,2,0,0,0,63,0
32,0,0,0,0,0,0,32,0
57,1,0,1,0,0,0,59,0
146,4,0,5,0,0,3,158,0
50,0,0,1,0,0,0,51,1
22,0,0,0,0,0,0,22,0
33,0,0,0,0,0,1,34,0
24,0,0,0,0,0,0,24,0
45,0,0,0,0,0,0,45,0
92,2,0,1,0,0,5,100,0
142,1,0,7,0,2,6,158,0
51,0,0,0,0,0,0,51,0
46,2,0,4,0,0,0,52,0
0,1,0,0,0,0,6,7,0
86,0,2,0,0,0,2,90,0
27,0,0,0,0,0,2,29,0
3,0,0,0,0,0,0,3,0
24,3,0,0,0,0,2,29,0
51,0,0,0,0,0,0,51,0
70,0,1,3,0,0,1,75,0
63,1,0,0,0,0,0,64,0
86,0,0,2,0,0,1,89,0
210,2,0,0,0,3,1,216,1
104,0,0,0,0,0,0,104,0
96,1,0,1,0,2,0,100,0
77,3,0,0,0,0,0,80,0
35,0,0,0,0,0,0,35,0
96,7,0,0,0,0,2,105,0
94,2,0,0,0,0,1,97,0
36,0,0,0,0,0,1,37,0
71,0,0,0,0,0,0,71,0
90,2,0,2,0,0,6,100,0
42,0,0,0,0,0,0,42,0
56,0,1,0,0,0,0,57,0
43,0,0,0,0,0,2,45,0
71,0,0,0,0,0,0,71,0
78,4,0,1,0,0,8,91,0
193,15,1,7,0,1,9,226,1
108,1,0,1,0,0,0,110,1
113,2,0,0,0,0,0,115,0
107,0,0,0,0,0,0,107,0
76,1,0,1,0,1,8,87,1
79,0,0,2,0,1,0,82,0
69,1,0,0,0,0,0,70,0
88,1,0,0,0,0,0,89,1
89,0,0,3,0,2,6,100,0
77,1,0,1,0,2,6,87,0
92,0,0,3,0,1,0,96,0
75,0,1,0,0,0,0,76,0
98,0,0,3,0,0,1,102,1
100,1,0,5,0,2,0,108,0
96,2,0,0,0,0,3,101,0
68,0,0,0,0,0,0,68,0
112,1,0,1,0,2,2,118,1
70,0,0,1,0,0,0,71,0
117,0,0,0,0,0,3,120,0
80,3,0,0,0,0,6,89,0
66,0,0,1,0,0,2,69,0
63,2,0,1,0,2,4,72,0
85,0,0,7,0,2,0,94,0
114,0,0,0,0,0,0,114,0
88,1,0,0,0,0,0,89,0
91,0,0,3,0,0,4,98,0
70,0,0,6,0,0,0,76,0
56,0,0,2,0,0,0,58,0
96,2,1,0,0,3,0,102,0
109,0,0,2,0,0,0,111,0
107,0,0,0,0,0,0,107,0
100,1,0,1,0,0,2,104,0
48,0,0,0,0,0,0,48,0
135,6,0,1,0,5,7,154,0
38,0,0,1,0,0,1,40,0
66,2,0,0,0,0,3,71,0
31,0,0,0,0,0,0,31,0
63,0,0,0,0,0,0,63,0
28,0,1,0,0,0,0,29,1
83,0,0,2,0,0,0,85,0
47,0,0,1,0,0,6,54,0
61,2,0,1,0,0,2,66,0
163,2,1,1,0,1,1,169,1
38,0,0,1,0,0,0,39,0
68,0,0,1,0,0,0,69,0
24,0,0,1,0,0,3,28,0
15,1,0,0,0,0,0,16,1
93,1,0,2,0,1,3,100,0
46,2,0,2,0,0,3,53,0
25,0,0,0,0,0,0,25,0
45,0,0,0,0,0,1,46,0
37,0,0,0,0,0,3,40,0
33,0,0,0,0,0,3,36,0
20,0,0,0,0,0,0,20,0
32,1,0,0,0,0,0,33,1
89,0,0,0,0,1,1,91,0
51,0,0,1,0,0,0,52,0
38,1,0,0,0,0,0,39,0
37,3,0,0,0,0,3,43,0
13,0,0,0,0,0,0,13,0
15,0,0,0,0,0,0,15,0
84,125,0,0,0,0,10,219,0
24,0,0,0,0,0,2,26,0
43,11,0,5,0,0,1,60,0
88,33,0,6,0,1,7,135,1
79,32,0,0,0,13,2,126,0
62,25,0,1,1,0,12,101,0
46,7,0,1,0,0,2,56,0
48,20,0,7,0,4,3,82,0
117,9,0,4,0,0,0,130,0
69,10,0,0,0,2,1,82,0
49,2,0,1,0,4,1,57,0
165,65,1,5,0,9,24,269,1
43,16,0,2,0,0,0,61,0
14,1,0,2,0,0,0,17,0
139,51,0,5,0,4,7,206,0
21,78,0,0,1,6,11,117,0
70,23,0,1,0,5,5,104,0
80,16,0,9,0,5,1,111,1
18,3,0,6,0,0,0,27,0
37,16,0,0,0,0,7,60,0
36,14,0,1,0,0,6,57,0
64,17,0,0,0,0,3,84,0
73,5,0,0,0,0,7,85,0
128,72,2,5,0,3,11,221,0
38,9,0,0,0,0,0,47,0
39,11,0,0,0,2,1,53,0
44,15,0,5,0,2,1,67,1
53,5,0,0,0,1,2,61,1
69,17,0,2,0,0,6,94,0
41,4,0,1,0,0,0,46,1
35,5,0,1,0,0,0,41,1
22,0,0,0,0,0,1,23,1
32,9,0,0,0,0,0,41,0
37,6,0,0,0,0,0,43,0
43,1,0,0,0,0,0,44,0
20,3,0,0,0,0,0,23,0
34,6,0,1,0,0,0,41,0
39,4,0,7,0,0,4,54,0
106,33,0,0,0,0,5,144,0
60,0,0,0,0,0,0,60,0
41,6,0,0,0,3,0,50,0
47,14,0,0,0,0,1,62,0
45,16,0,4,0,0,1,66,0
54,8,0,0,0,0,0,62,0
59,2,0,0,0,0,0,61,0
42,7,0,1,0,0,1,51,0
63,4,0,0,0,0,0,67,0
96,9,0,0,0,1,11,117,1
45,0,0,0,0,6,3,54,0
47,2,0,3,0,0,2,54,0
32,1,0,0,0,0,0,33,1
32,1,0,0,0,2,0,35,0
44,4,0,0,0,5,0,53,0
26,3,0,0,0,0,0,29,0
55,9,1,0,0,0,4,69,1
47,20,0,4,0,0,0,71,0
45,8,0,0,0,0,3,56,0
47,12,0,1,0,0,0,60,0
46,18,0,0,0,0,1,65,0
36,0,0,0,0,5,2,43,0
62,5,0,2,0,0,1,70,1
42,6,0,0,0,5,4,57,0
136,24,4,1,0,11,8,184,0
60,15,0,0,0,3,5,83,0
51,6,0,0,0,0,0,57,0
63,3,0,4,0,0,0,70,0
48,2,0,0,0,4,5,59,0
40,0,0,0,0,4,4,48,0
17,0,1,0,0,2,0,20,0
37,6,0,1,0,5,1,50,0
22,4,0,0,0,0,1,27,0
38,2,0,0,0,0,3,43,0
95,33,0,0,0,0,7,135,0
24,6,0,0,0,0,0,30,0
33,5,0,0,0,0,0,38,0
34,5,0,0,0,2,0,41,0
57,17,0,0,0,0,0,74,0
30,1,0,0,0,0,4,35,0
43,15,1,0,0,0,0,59,0
135,27,0,5,0,3,14,184,0
66,39,0,0,0,0,0,105,0
37,14,0,0,0,0,1,52,0
35,9,0,0,0,0,0,44,0
57,41,0,0,0,9,0,107,0
73,12,0,4,0,0,10,99,0
92,16,1,3,0,7,7,126,0
40,4,0,0,0,0,2,46,0
49,20,0,1,0,5,7,82,0
46,20,0,0,0,0,7,73,0
48,24,0,0,0,5,0,77,0
50,44,0,0,0,0,7,101,0
27,20,0,4,0,0,0,51,0
43,10,0,3,0,0,0,56,0
41,21,0,0,0,0,0,62,0
53,23,0,5,0,0,0,81,0
61,22,0,0,0,0,0,83,0
32,28,0,0,0,0,6,66,0
147,27,0,1,1,0,6,182,0
43,5,0,0,0,5,2,55,0
68,12,0,0,0,14,8,102,0
65,5,0,0,0,0,0,70,0
65,30,0,0,0,0,2,97,0
25,8,0,0,0,0,0,33,0
28,4,0,0,0,0,1,33,0
170,4,1,5,0,2,2,184,0
66,0,0,0,0,0,0,66,0
62,0,0,4,0,0,0,66,0
62,0,0,1,0,0,0,63,0
27,6,0,1,0,0,0,34,0
97,4,0,0,0,5,0,106,0
53,2,0,0,0,0,1,56,1
45,0,0,0,0,0,0,45,0
38,6,0,0,0,0,0,44,0
245,10,0,7,0,2,5,269,0
74,0,2,4,0,0,0,80,0
214,5,0,0,0,1,4,224,0
241,4,0,15,0,1,9,270,1
62,4,0,1,0,1,2,70,0
84,2,1,1,0,0,2,90,0
89,1,0,3,0,0,3,96,0
96,7,0,4,0,1,4,112,1
137,1,4,2,0,0,2,146,0
127,1,1,1,1,2,9,142,0
164,4,0,3,0,4,8,183,0
70,1,0,1,0,0,1,73,0
219,7,0,2,0,3,7,238,0
168,0,0,6,0,1,6,181,0
141,4,0,0,0,3,3,151,0
51,0,0,2,0,0,0,53,0
27,0,0,0,0,0,0,27,0
24,0,0,0,0,0,0,24,0
24,1,0,0,0,0,0,25,1
24,0,0,0,0,0,0,24,0
81,2,0,1,0,0,5,89,1
190,0,0,2,0,0,4,196,0
65,3,0,1,0,0,0,69,0
56,0,0,1,0,0,0,57,0
69,0,0,1,0,0,4,74,1
76,3,0,1,0,1,0,81,0
63,2,1,1,0,0,1,68,0
69,0,0,0,0,1,2,72,0
37,0,0,0,0,0,0,37,0
79,0,0,0,0,0,4,83,0
44,2,0,2,0,0,1,49,0
59,1,1,0,0,1,0,62,0
142,15,1,1,0,0,5,164,2
83,2,0,0,0,0,3,88,0
87,3,0,8,0,1,0,99,0
85,0,0,1,0,0,1,87,0
36,0,0,1,0,0,0,37,0
17,1,0,0,0,1,0,19,0
121,0,0,1,0,0,1,123,0
47,1,0,3,0,0,0,51,0
23,5,0,0,0,0,0,28,0
162,0,2,0,0,0,0,164,0
16,0,0,0,0,1,1,18,1
60,0,0,4,0,0,0,64,0
88,3,0,0,0,0,8,99,0
214,3,1,5,0,0,7,230,0
94,2,0,1,0,0,1,98,1
96,0,0,6,0,0,8,110,0
5,0,0,0,0,0,0,5,0
43,3,0,1,0,0,6,53,0
54,2,0,0,0,1,1,58,1
57,1,0,4,0,0,4,66,0
46,2,0,0,0,0,3,51,0
52,1,0,0,0,0,1,54,0
58,6,1,1,0,0,1,67,0
62,0,0,1,0,2,2,67,0
45,1,0,1,0,0,1,48,0
49,0,0,3,0,0,3,55,0
53,0,0,3,0,0,3,59,0
68,0,0,0,0,0,0,68,0
48,0,0,0,0,0,1,49,1
60,1,0,0,0,0,0,61,0
49,2,0,0,0,0,0,51,0
52,1,0,0,0,0,0,53,0
46,2,0,2,0,0,1,51,0
203,6,3,4,0,0,4,220,0
30,11,0,0,0,0,0,41,0
18,0,0,0,0,0,0,18,0
53,1,1,1,0,0,0,56,1
78,3,1,2,0,0,4,88,0
81,2,0,5,0,0,5,93,0
92,2,0,11,0,0,5,110,0
224,3,1,3,0,0,6,237,0
59,2,0,0,0,0,1,62,0
56,3,0,1,0,0,0,60,0
47,2,0,1,0,0,0,50,1
56,1,0,3,0,0,0,60,0
55,1,0,2,0,0,1,59,0
57,0,0,1,0,0,1,59,1
143,4,0,44,0,8,8,207,0
41,3,0,1,0,1,4,50,0
60,0,0,0,0,0,0,60,0
74,0,0,0,0,0,0,74,0
44,3,0,0,0,0,1,48,0
49,0,1,1,0,0,2,53,0
52,2,0,0,0,3,0,57,0
80,0,0,0,0,0,1,81,0
65,3,0,0,0,0,1,69,0
53,1,0,1,0,2,3,60,0
40,0,0,0,0,0,0,40,0
129,6,0,5,0,0,3,143,0
593,24,0,155,0,14,22,808,0
5,0,0,0,0,0,0,5,0
55,1,0,14,0,2,0,72,0
30,1,0,2,0,0,0,33,0
40,2,0,21,0,0,5,68,0
71,2,0,0,0,2,3,78,0
55,4,0,2,0,0,0,61,0
104,2,0,3,0,0,6,115,0
89,0,0,3,0,2,1,95,1
118,4,1,3,0,0,4,130,0
3,0,0,0,0,0,0,3,0
97,4,0,1,0,0,2,104,0
38,0,0,0,0,0,0,38,0
86,5,0,4,1,2,7,105,0
62,16,0,1,0,2,5,86,0
77,11,1,0,0,2,5,96,0
51,10,0,0,0,1,0,62,1
43,0,0,1,0,0,1,45,1
22,0,0,0,0,0,2,24,0
14,0,0,0,0,0,0,14,0
26,2,0,0,0,1,1,30,0
28,1,0,0,0,0,0,29,1
25,0,0,0,0,0,0,25,0
28,0,0,0,0,0,2,30,0
16,0,0,2,0,0,7,25,0
40,0,0,0,0,0,1,41,1
50,2,0,1,0,1,8,62,0
54,7,0,1,0,0,4,66,0
39,7,0,0,0,0,1,47,0
47,5,0,0,0,5,1,58,0
86,0,0,3,0,0,6,95,0
46,0,0,0,0,0,1,47,0
103,2,0,1,0,5,5,116,0
33,6,0,0,0,1,0,40,0
105,0,0,2,0,0,7,114,0
36,0,0,0,0,0,0,36,0
10,0,0,1,0,1,1,13,0
71,3,6,2,0,0,1,83,0
48,1,0,8,0,0,4,61,0
64,0,5,1,0,0,1,71,1
60,0,1,0,0,0,2,63,0
24,0,0,1,0,2,0,27,0
61,3,0,1,0,1,0,66,2
30,1,0,5,0,0,0,36,0
50,4,0,0,0,1,6,61,0
51,5,0,0,0,0,1,57,0
55,2,0,0,0,0,3,60,0
52,1,0,1,0,0,1,55,0
19,0,0,0,0,0,0,19,0
18,1,0,5,0,0,0,24,1
21,0,0,4,0,0,0,25,0
30,1,0,0,0,0,0,31,0
37,2,0,1,0,0,0,40,0
10,3,1,0,0,0,0,14,0
6,0,0,0,0,0,0,6,0
39,3,0,0,0,0,0,42,0
141,2,1,74,0,2,3,223,0
70,10,3,7,0,3,4,97,0
28,0,0,0,0,0,0,28,0
28,0,0,0,0,1,3,32,0
69,4,0,6,0,0,3,82,0
55,2,0,1,0,0,5,63,0
68,6,0,2,0,0,8,84,0
42,5,0,0,0,0,2,49,0
22,1,0,2,0,0,1,26,0
48,3,0,0,0,0,5,56,0
58,2,0,0,0,4,0,64,0
26,1,0,0,0,0,2,29,0
7,3,0,0,0,1,2,13,1
65,4,0,0,0,1,2,72,0
7,0,0,0,0,0,1,8,1
10,0,1,0,0,0,1,12,0
56,8,0,0,0,0,0,64,0
7,0,0,0,0,0,0,7,0
28,20,0,0,0,0,4,52,0
27,14,0,5,1,0,4,51,0
40,20,0,1,0,0,10,71,0
47,20,1,0,0,0,14,82,0
43,9,0,0,0,0,9,61,0
31,29,0,2,0,0,5,67,0
45,25,0,0,0,0,4,74,0
52,13,0,0,0,3,4,72,0
30,47,0,0,0,5,0,82,0
6,16,0,0,0,0,0,22,0
4,26,0,0,0,0,2,32,0
34,66,1,0,0,0,8,109,1
13,42,2,0,0,0,4,61,0
59,39,0,2,0,3,1,104,0
53,21,0,1,0,0,2,77,0
74,11,0,0,0,0,4,89,0
54,14,0,0,0,0,6,74,0
43,8,0,0,0,1,0,52,0
78,20,1,0,0,0,2,101,0
92,26,0,0,0,0,2,120,0
57,18,1,0,0,0,2,78,0
43,28,0,4,0,4,5,84,0
50,37,0,1,0,1,0,89,0
74,27,0,0,0,1,3,105,0
106,27,0,0,1,2,13,149,0
105,33,0,0,0,2,6,146,0
97,29,0,0,0,9,14,149,0
63,36,0,0,0,2,7,108,0
25,16,0,0,0,0,3,44,0
88,34,0,2,0,11,3,138,0
32,3,0,0,0,5,1,41,1
51,3,0,0,0,0,0,54,0
73,46,1,1,0,6,3,130,0
35,9,0,0,0,0,0,44,0
32,15,0,0,0,1,2,50,0
40,4,1,0,0,0,0,45,0
53,12,0,0,0,0,3,68,0
40,8,0,0,0,0,0,48,0
40,2,0,0,0,0,0,42,0
30,7,0,0,0,0,0,37,0
1,53,0,0,0,0,0,54,0
7,43,0,0,0,0,0,50,0
5,49,1,1,0,1,1,58,0
2,15,0,0,0,0,0,17,0
10,42,0,0,0,1,0,53,0
2,54,0,0,0,0,0,56,0
8,51,0,0,0,0,0,59,0
7,64,0,0,0,5,0,76,0
0,23,0,0,0,0,0,23,0
5,14,0,0,0,0,2,21,0
7,18,0,0,0,0,3,28,0
0,18,0,0,0,0,0,18,0
5,47,0,0,0,0,5,57,0
0,30,0,0,0,0,1,31,0
13,135,0,0,0,0,11,159,0
29,179,2,1,0,0,4,215,0
0,26,0,0,0,0,0,26,0
0,19,0,0,0,0,0,19,0
0,24,0,0,0,0,0,24,0
10,55,0,0,0,0,0,65,0
10,22,0,0,0,0,5,37,0
6,43,0,0,0,0,0,49,0
0,35,0,0,0,0,1,36,1
16,61,0,0,0,0,1,78,0
3,75,0,0,0,0,4,82,0
0,43,0,0,0,0,0,43,0
2,25,0,0,0,0,0,27,0
16,36,0,0,0,0,13,65,0
22,42,0,0,0,0,0,64,0
26,16,0,0,0,0,6,48,0
18,28,0,1,0,0,6,53,0
26,27,1,0,0,0,4,58,0
35,37,1,0,0,0,1,74,2
39,13,0,0,0,5,0,57,0
26,20,0,0,0,6,3,55,0
22,7,2,0,0,1,1,33,0
55,11,0,0,0,1,1,68,0
29,38,0,3,0,0,0,70,0
19,52,1,0,0,1,0,73,0
25,35,0,1,0,0,5,66,0
28,30,0,1,0,0,5,64,1
60,14,1,0,0,0,0,75,0
8,86,1,0,0,0,1,96,0
0,48,0,0,0,2,0,50,0
0,39,0,1,0,0,1,41,1
1,80,0,0,0,1,0,82,0
0,76,0,0,0,0,5,81,0
3,34,0,0,0,0,0,37,0
0,22,0,0,0,0,0,22,0
0,27,0,0,0,0,0,27,0
1,21,0,0,0,0,2,24,0
0,14,0,2,0,1,6,23,0
2,54,0,0,0,0,0,56,0
19,102,1,0,0,2,8,132,0
1,94,0,5,0,0,0,100,0
0,4,0,0,0,0,0,4,0
5,53,1,0,0,0,0,59,0
0,59,0,0,0,0,0,59,0
7,47,0,0,0,0,0,54,0
0,55,0,0,0,1,0,56,0
0,44,0,0,0,0,1,45,0
18,48,0,0,0,0,0,66,0
2,83,4,0,0,0,0,89,0
0,38,0,0,0,0,0,38,0
6,31,0,0,0,0,0,37,0
1,104,0,0,0,0,2,107,0
0,14,0,0,0,0,0,14,0
4,55,0,1,0,0,3,63,0
3,49,0,0,0,0,1,53,0
4,51,0,0,0,0,0,55,0
4,35,0,0,0,0,0,39,0
1,36,0,0,0,0,1,38,1
3,57,1,0,0,0,4,65,0
6,40,0,0,0,0,3,49,0
3,75,0,0,0,0,0,78,0
12,79,0,0,0,2,1,94,0
3,89,1,0,0,2,3,98,0
3,43,0,0,0,0,2,48,0
3,47,0,0,0,8,2,60,0
1,46,0,0,0,2,1,50,0
8,24,0,0,0,6,1,39,0
8,87,1,0,0,0,2,98,0
5,96,0,0,0,0,7,108,0
7,102,2,0,0,0,2,113,0
2,17,0,0,0,0,0,19,0
0,33,0,0,0,0,0,33,0
0,55,0,0,0,1,0,56,0
3,54,0,0,0,0,1,58,0
1,44,0,0,0,0,0,45,0
0,49,0,1,0,0,0,50,0
0,46,0,0,0,0,2,48,0
15,43,0,0,0,0,4,62,0
4,69,0,0,0,0,4,77,0
0,45,0,0,0,0,0,45,0
2,45,0,0,0,0,3,50,0
32,11,0,0,0,0,0,43,0
31,35,0,9,0,0,3,78,0
27,49,0,0,0,0,2,78,0
28,13,0,0,0,0,2,43,0
37,9,0,0,0,0,0,46,0
69,22,0,0,0,0,1,92,1
38,16,0,0,0,0,0,54,0
43,27,0,0,0,0,0,70,0
86,18,0,0,0,0,9,113,0
51,20,0,0,0,0,2,73,0
59,11,0,0,0,0,0,70,0
68,30,0,0,0,0,2,100,0
35,13,0,0,0,0,3,51,0
28,11,0,1,0,0,0,40,0
24,3,0,2,0,0,0,29,0
26,6,0,0,0,0,0,32,0
37,21,0,2,0,3,0,63,0
29,27,0,0,0,0,0,56,0
84,25,0,2,0,1,4,116,0
43,30,0,0,0,0,0,73,0
49,9,0,0,0,0,0,58,0
47,19,0,0,0,5,0,71,0
18,3,0,1,0,0,3,25,0
53,7,0,0,0,0,0,60,0
23,18,0,0,0,0,1,42,1
31,23,1,0,0,0,3,58,0
42,9,1,0,0,0,8,60,0
61,41,0,0,0,1,2,105,0
37,17,0,1,0,0,1,56,2
53,11,0,0,0,0,0,64,0
50,23,0,1,0,1,10,85,1
60,14,0,5,0,7,0,86,0
43,38,0,0,0,0,10,91,0
20,11,0,0,0,0,0,31,0
3,7,0,3,0,0,0,13,0
29,27,0,2,0,0,0,58,0
19,20,0,0,0,0,0,39,0
17,10,0,0,0,0,5,32,0
29,12,0,0,0,0,6,47,0
32,13,0,5,0,0,0,50,0
34,46,0,2,0,2,5,89,0
109,218,1,0,0,5,14,347,0
28,43,0,0,0,0,1,72,0
21,28,0,0,0,5,0,54,0
4,10,0,0,0,0,1,15,0
7,10,0,0,0,0,4,21,0
6,8,0,0,0,0,0,14,0
21,73,0,0,0,0,0,94,0
23,26,0,0,0,0,2,51,0
10,15,0,0,0,1,0,26,0
1,4,0,0,0,0,0,5,0
17,2,0,0,0,1,0,20,0
4,1,0,0,0,0,1,6,1
8,10,0,0,0,0,0,18,0
7,10,0,1,0,1,0,19,0
4,7,0,0,0,0,0,11,0
11,8,0,0,0,0,0,19,0
0,8,0,0,0,0,1,9,0
1,14,0,0,0,0,0,15,0
19,4,0,0,0,0,0,23,0
0,16,0,0,0,0,0,16,0
2,9,0,0,0,0,0,11,0
16,20,0,0,0,0,0,36,0
6,5,0,0,0,0,0,11,0
0,14,0,0,0,0,0,14,0
0,5,0,0,0,0,2,7,0
12,7,0,0,0,0,0,19,0
15,21,0,0,0,0,7,43,0
29,48,0,0,0,1,4,82,0
18,27,0,0,0,0,0,45,0
35,60,1,0,1,0,7,104,0
6,38,0,0,0,0,0,44,0
7,73,0,0,0,0,0,80,0
9,28,0,0,0,1,4,42,0
2,0,0,0,0,0,0,2,0
3,0,0,0,0,0,0,3,0
0,1,0,0,0,0,0,1,0
0,8,0,0,0,0,0,8,0
17,25,0,0,0,3,2,47,0
27,16,1,0,0,4,0,48,0
17,11,0,6,0,0,1,35,0
16,12,0,0,0,0,0,28,0
11,14,0,0,0,0,2,27,0
8,24,0,0,0,0,0,32,0
12,25,0,0,0,0,2,39,0
19,14,0,0,0,0,0,33,0
31,3,0,0,0,2,0,36,0
10,11,0,0,0,0,2,23,0
16,2,0,0,0,0,4,22,0
8,22,0,0,0,5,3,38,0
0,0,0,0,0,0,1,1,0
10,0,0,1,0,0,1,12,0
7,41,0,0,0,2,0,50,0
10,14,1,0,0,0,1,26,0
1,26,0,0,0,0,0,27,0
20,16,0,6,0,0,0,42,0
32,3,0,0,0,0,0,35,0
15,4,0,1,0,0,2,22,0
24,0,0,0,0,0,4,28,0
26,5,0,0,0,0,0,31,0
33,0,0,0,0,0,0,33,0
23,2,3,0,0,0,2,30,0
10,3,0,1,0,0,0,14,0
4,1,0,0,0,0,2,7,1
4,3,0,0,0,0,0,7,0
6,6,0,0,0,0,0,12,0
6,1,0,0,0,0,0,7,0
15,9,0,0,0,0,0,24,0
9,3,0,1,0,0,0,13,0
20,3,0,0,1,0,1,25,1
11,1,0,0,0,0,0,12,0
3,5,0,0,0,0,0,8,0
8,0,0,0,0,1,1,10,0
6,3,0,0,0,0,0,9,0
12,5,0,0,0,0,1,18,0
12,11,0,0,0,0,0,23,0
0,7,0,0,0,0,0,7,0
0,0,0,0,0,0,2,2,0
6,0,0,3,0,0,0,9,0
26,1,2,0,0,0,0,29,0
22,5,0,0,0,0,0,27,0
0,0,0,0,0,0,1,1,1
22,16,0,0,0,0,0,38,0
11,7,0,0,0,0,2,20,0
16,3,0,0,0,6,0,25,0
7,0,0,0,0,0,0,7,0
7,3,0,0,0,0,0,10,0
10,6,0,0,0,7,0,23,0
23,13,0,6,0,0,2,44,0
12,4,0,0,0,0,0,16,0
14,0,0,0,0,0,4,18,0
30,5,0,1,0,0,0,36,1
2,7,0,0,0,0,0,9,0
22,2,0,0,0,2,2,28,0
23,14,0,0,0,1,1,39,0
5,4,0,0,0,1,0,10,0
7,4,0,0,0,0,2,13,0
22,22,0,0,0,0,0,44,0
3,0,0,0,0,0,0,3,0
10,8,0,6,0,0,0,24,0
19,1,0,0,0,0,6,26,0
21,2,0,0,0,0,0,23,0
15,2,0,0,0,0,0,17,0
29,2,0,0,0,1,3,35,0
62,41,0,4,0,2,6,115,0
0,2,0,0,0,0,0,2,0
17,1,0,0,0,0,0,18,0
14,0,0,0,0,0,0,14,0
11,1,0,0,0,0,1,13,1
10,1,1,1,0,0,1,14,0
18,0,0,0,0,0,3,21,0
43,52,0,0,0,0,0,95,0
64,73,1,0,0,0,11,149,0
12,42,0,0,0,1,0,55,0
19,94,0,0,0,0,6,119,0
0,33,0,0,0,0,0,33,0
12,58,0,0,0,0,0,70,0
10,31,0,1,0,6,0,48,0
1,47,0,0,0,4,0,52,0
2,38,0,0,0,0,1,41,0
27,30,1,0,0,0,0,58,0
21,26,0,0,1,0,0,48,0
29,28,0,0,0,0,1,58,0
19,31,0,0,0,2,7,59,0
23,20,0,0,0,0,6,49,0
12,18,0,0,0,3,0,33,0
40,5,0,0,0,0,0,45,0
25,60,0,0,0,0,10,95,0
27,21,0,2,0,1,8,59,0
27,27,0,2,0,0,0,56,0
30,49,0,0,0,0,2,81,0
5,51,0,0,0,0,4,60,0
14,18,0,0,0,0,3,35,0
8,18,0,0,0,0,5,31,0
13,19,0,0,0,0,1,33,0
23,34,0,0,0,0,10,67,0
21,38,0,0,0,0,4,63,0
11,51,0,0,0,2,1,65,0
10,48,0,0,0,0,2,60,0
7,22,0,0,0,1,3,33,0
16,47,0,0,0,0,2,65,0
8,64,0,0,0,1,2,75,0
22,62,0,0,0,0,6,90,0
1,47,1,0,0,0,4,53,1
11,26,0,0,0,0,1,38,0
9,34,0,3,0,1,12,59,0
3,60,0,0,0,0,5,68,0
0,19,0,0,0,3,1,23,0
0,15,0,0,0,0,0,15,0
18,61,0,0,0,0,0,79,0
8,92,0,0,1,0,1,102,1
6,73,0,0,0,0,5,84,0
4,91,0,0,0,0,3,98,0
24,36,0,0,0,1,0,61,0
24,34,0,0,0,1,3,62,0
17,42,0,0,0,0,1,60,0
11,56,0,0,0,0,1,68,0
16,49,3,0,0,1,1,70,0
18,43,0,0,0,0,0,61,0
1,59,0,0,0,0,6,66,0
1,51,1,0,0,0,5,58,0
20,43,0,0,0,0,2,65,0
7,43,0,0,0,0,0,50,0
0,57,0,1,0,5,1,64,1
0,42,0,0,0,0,1,43,0
7,68,0,0,0,5,2,82,0
37,90,1,0,0,16,5,149,0
20,41,1,0,0,1,0,63,0
5,6,0,0,0,0,0,11,0
1,5,0,0,0,0,4,10,0
0,2,0,0,0,0,0,2,0
8,6,0,0,0,0,3,17,0
10,18,2,0,0,0,2,32,0
35,191,1,0,0,3,15,245,0
0,10,0,0,0,0,0,10,0
0,0,0,0,0,2,0,2,0
13,9,0,0,0,0,0,22,0
5,15,0,0,0,0,0,20,0
9,24,0,0,0,0,1,34,1
7,22,0,0,0,0,2,31,0
1,14,0,1,0,0,0,16,0
0,8,0,0,0,0,0,8,0
3,13,0,0,0,0,0,16,0
13,11,0,0,0,2,0,26,0
3,6,0,0,0,0,0,9,0
4,8,0,0,0,0,1,13,0
14,15,1,0,0,0,0,30,0
23,89,0,0,0,6,11,129,0
21,87,0,2,0,0,2,112,0
13,36,0,0,0,0,4,53,0
12,45,0,0,0,2,3,62,0
6,23,0,0,0,0,0,29,0
6,39,0,0,0,0,6,51,0
6,32,0,0,0,0,3,41,0
11,50,0,0,1,0,4,66,0
6,6,0,0,0,0,0,12,0
5,8,0,0,0,0,0,13,0
2,10,0,0,0,0,2,14,0
6,18,0,0,0,0,0,24,0
11,24,0,0,0,0,1,36,0
1,16,0,0,0,0,0,17,0
4,19,0,0,0,0,4,27,0
6,17,0,0,0,0,0,23,0
2,22,0,0,0,0,2,26,0
1,0,0,0,0,0,0,1,1
3,15,0,0,0,0,0,18,0
0,2,0,0,0,0,0,2,0
0,11,0,0,0,0,0,11,0
4,2,0,0,0,0,0,6,0
16,28,1,0,0,1,0,46,0
3,2,0,0,0,0,2,7,0
6,12,0,0,0,2,1,21,0
8,19,0,2,0,0,2,31,0
4,15,0,0,0,0,1,20,0
0,4,0,0,0,0,0,4,0
0,12,0,0,0,0,0,12,0
5,20,0,0,0,2,4,31,0
0,10,0,0,0,0,0,10,0
1,4,0,0,0,0,0,5,0
3,10,0,0,0,0,3,16,0
1,21,0,0,0,0,0,22,0
1,3,0,1,0,0,0,5,1
2,10,0,0,0,0,0,12,0
8,30,0,0,0,0,0,38,0
7,26,0,0,0,0,0,33,0
8,17,0,0,0,0,1,26,0
0,3,0,0,0,0,2,5,0
2,6,0,0,0,0,0,8,0
0,4,0,0,0,0,0,4,0
1,37,0,0,0,0,0,38,0
0,25,0,0,0,0,0,25,0
2,19,0,0,0,0,0,21,0
6,25,0,0,0,0,0,31,0
0,9,0,0,0,0,0,9,0
10,36,0,0,0,0,4,50,0
153,2,0,7,0,0,8,170,0
117,1,0,5,0,0,2,125,0
42,4,2,1,0,0,1,50,0
103,4,0,8,1,0,0,116,0
75,1,0,5,0,1,3,85,1
159,3,1,19,0,0,5,187,0
317,6,1,12,0,6,6,348,0
101,10,1,0,0,0,3,115,0
139,9,0,1,0,9,7,165,0
110,8,4,2,0,1,1,126,0
93,8,0,3,0,0,3,107,0
140,2,0,2,0,0,2,146,0
303,26,2,16,0,6,14,367,0
96,5,1,1,0,0,4,107,0
25,0,0,3,0,1,3,32,0
146,7,0,7,0,0,9,169,0
104,13,0,4,0,0,5,126,0
95,13,0,0,0,0,4,112,0
35,2,0,0,0,2,0,39,0
32,1,0,0,0,0,0,33,0
63,1,0,0,0,0,2,66,0
64,1,0,4,0,0,0,69,1
87,3,0,1,0,2,2,95,1
79,3,0,2,0,0,0,84,0
142,5,0,2,0,2,4,155,0
157,5,0,2,0,2,2,168,0
153,0,1,2,0,4,5,165,0
333,5,0,13,0,3,6,360,0
178,3,0,15,0,2,3,201,0
39,0,0,13,0,0,3,55,0
170,5,0,2,0,2,4,183,0
148,4,3,2,0,3,1,161,0
53,5,0,0,0,0,1,59,0
33,0,0,0,0,1,0,34,0
59,2,0,2,0,0,0,63,0
49,0,0,1,0,1,0,51,0
99,2,3,3,0,0,2,109,0
67,2,0,1,0,0,1,71,0
83,4,0,3,0,0,0,90,0
93,1,0,3,0,0,6,103,0
60,5,0,1,0,0,0,66,0
35,1,0,4,0,0,0,40,0
30,0,0,0,0,0,2,32,0
45,0,0,7,0,0,0,52,0
37,1,1,1,0,0,1,41,3
67,3,0,8,0,2,7,87,0
11,1,0,0,0,1,0,13,0
55,0,0,1,1,0,0,57,2
35,0,0,2,0,0,0,37,0
96,2,2,3,0,0,1,104,0
75,0,0,2,0,0,2,79,0
144,0,0,5,0,0,6,155,0
91,5,1,10,0,3,2,112,0
187,4,0,2,0,4,8,205,0
71,0,0,5,0,1,1,78,0
133,2,0,23,1,4,9,172,0
97,2,2,22,0,0,4,127,0
85,0,0,4,0,1,0,90,0
84,0,0,2,0,0,1,87,0
128,0,0,3,0,0,2,133,0
108,4,0,6,0,1,0,119,0
189,3,0,27,0,1,4,224,0
121,0,1,18,0,1,0,141,1
318,6,0,37,0,1,6,368,0
284,6,2,109,0,0,9,410,0
166,3,0,47,0,3,5,224,0
564,57,2,83,0,18,6,730,0
361,8,0,77,1,4,17,468,0
1900,110,5,113,0,27,6,2161,0
486,14,0,91,0,3,1,595,0
5,1,0,0,0,0,0,6,1
1779,90,7,125,0,27,5,2033,0
13,0,0,10,0,0,1,24,0
11,0,0,4,0,0,1,16,1
36,1,0,0,0,0,0,37,0
41,5,0,5,0,0,2,53,0
16,1,0,7,0,0,0,24,0
1976,135,6,174,0,47,13,2351,0
110,57,0,329,0,5,16,517,0
211,6,1,7,0,0,6,231,0
28,0,0,0,0,0,0,28,0
2,0,0,0,0,0,0,2,0
12,1,0,4,0,0,0,17,0
82,5,0,39,0,6,4,136,0
29,2,0,1,0,2,2,36,0
324,73,0,41,0,2,12,452,0
55,5,0,7,0,2,0,69,0
1207,189,7,140,0,43,5,1591,0
62,15,0,3,0,0,0,80,0
286,34,0,29,0,1,3,353,0
106,11,0,0,0,2,5,124,0
152,1,1,5,0,4,5,168,2
46,2,0,1,0,0,0,49,0
190,4,2,6,0,3,4,209,0
126,0,0,3,0,0,2,131,0
187,11,0,4,0,5,7,214,0
133,43,1,3,1,4,5,190,0
230,12,0,17,0,4,6,269,0
231,1,0,2,0,2,1,237,0
172,5,0,8,0,0,0,185,0
176,1,0,5,0,1,3,186,0
330,2,0,10,0,3,7,352,0
23,0,0,0,0,0,0,23,0
98,1,0,0,0,0,1,100,0
19,0,0,1,0,0,0,20,0
74,3,0,3,0,0,2,82,0
160,0,0,6,0,0,3,169,0
224,1,0,10,0,1,3,239,1
117,0,0,8,0,1,1,127,0
228,14,0,34,1,5,5,287,0
217,2,0,2,0,0,5,226,0
173,6,0,5,0,3,7,194,0
294,4,0,12,0,1,8,319,0
15,0,0,2,0,0,0,17,0
20,1,0,0,0,0,1,22,1
301,12,0,9,0,1,7,330,0
86,31,1,3,0,0,3,124,0
153,24,0,7,0,1,8,193,1
182,21,0,17,0,1,21,242,0
179,55,3,4,0,1,12,254,1
114,98,0,16,0,0,13,241,0
172,42,1,20,0,12,9,256,0
265,8,0,11,0,1,5,290,1
284,4,0,19,0,0,5,312,0
345,15,0,17,0,4,3,384,0
216,19,2,15,0,6,5,263,0
105,18,0,15,0,3,1,142,0
284,6,0,6,0,7,5,308,0
161,16,0,0,0,0,3,180,0
278,1,0,7,1,2,0,289,0
399,14,0,19,0,1,8,441,0
23,0,0,0,0,0,0,23,0
9,0,0,0,0,0,0,9,0
356,9,0,16,1,1,8,391,0
252,0,1,3,0,1,0,257,1
278,2,0,21,0,8,4,313,0
211,2,0,12,0,2,3,230,0
25,0,0,1,0,1,1,28,0
500,8,1,30,1,3,12,555,0
23,0,0,4,0,0,0,27,0
317,4,1,24,0,0,5,351,1
397,4,0,16,0,1,6,424,0
50,2,1,1,0,1,1,56,1
3,49,0,0,0,0,1,53,0
0,37,0,0,0,0,6,43,0
0,17,0,0,0,0,0,17,0
19,99,1,0,0,0,2,121,0
3,51,0,0,0,0,0,54,0
3,40,0,0,0,0,0,43,0
1,42,0,0,0,0,0,43,0
8,109,0,0,0,0,4,121,0
2,23,0,0,0,0,2,27,0
7,42,0,0,0,0,4,53,0
5,61,0,0,0,0,0,66,0
23,19,1,0,0,0,0,43,0
0,5,0,0,0,0,2,7,0
8,47,0,0,0,0,4,59,0
5,61,0,0,0,2,1,69,0
0,5,0,0,0,0,0,5,0
1,53,0,0,0,0,4,58,0
12,34,0,0,0,0,6,52,0
4,14,0,0,0,2,1,21,0
4,44,0,0,0,0,0,48,0
3,0,0,0,0,0,0,3,0
0,0,0,2,0,0,0,2,0
0,1,0,0,0,0,0,1,0
1,1,0,0,0,0,0,2,1
12,39,0,1,0,0,6,58,1
61,80,0,0,0,0,3,144,0
0,3,0,0,0,0,0,3,0
2,81,1,0,0,0,9,93,0
6,63,0,0,0,0,0,69,0
8,74,0,0,0,0,0,82,0
3,16,0,0,0,0,0,19,0
2,9,0,1,0,0,0,12,0
9,29,0,0,0,0,0,38,0
2,8,0,0,1,0,0,11,0
0,3,0,0,0,0,0,3,0
3,91,0,0,0,0,1,95,1
1,57,0,0,0,0,0,58,0
5,25,0,0,0,0,2,32,0
1,76,0,0,0,0,3,80,0
0,5,0,0,0,0,0,5,0
0,3,0,0,0,0,0,3,0
0,35,0,0,0,2,0,37,0
5,215,0,0,0,0,3,223,0
1,45,0,1,0,2,5,54,1
2,15,3,0,0,0,0,20,0
6,32,0,0,0,0,0,38,0
1,36,0,0,13,0,1,51,0
0,2,0,0,0,0,0,2,0
0,59,0,0,9,0,1,69,0
0,20,0,0,0,0,0,20,0
0,62,3,0,23,0,0,88,0
9,113,0,0,0,0,3,125,0
2,214,0,6,1,2,7,232,0
0,48,0,3,0,0,3,54,0
1,29,0,0,1,0,0,31,1
5,34,0,0,0,0,1,40,1
10,17,0,0,0,0,0,27,0
2,25,0,0,0,0,0,27,0
2,28,0,9,0,0,2,41,0
13,152,0,0,0,0,0,165,0
9,34,0,0,0,0,1,44,0
0,5,0,0,0,0,0,5,0
2,48,0,0,0,0,2,52,0
0,58,0,0,0,0,0,58,0
4,58,0,0,0,0,0,62,0
0,45,0,1,0,0,1,47,0
14,46,0,0,0,0,3,63,0
0,1,0,0,0,0,0,1,0
0,41,0,0,0,0,1,42,0
1,36,0,1,0,0,2,40,1
43,95,0,0,1,8,14,161,0
5,51,0,0,0,0,0,56,0
8,73,0,0,0,0,3,84,0
3,127,0,0,0,8,4,142,0
22,90,2,0,1,2,13,130,0
9,17,0,0,0,0,0,26,0
17,29,3,0,0,0,9,58,0
6,11,0,1,0,0,0,18,0
1,21,0,0,0,3,0,25,0
6,102,0,0,0,8,3,119,0
17,111,1,0,0,17,5,151,1
38,90,1,0,0,1,3,133,0
20,57,0,0,0,0,2,79,0
24,7,0,0,0,0,1,32,0
45,13,0,0,0,1,0,59,0
23,14,0,0,0,0,6,43,0
32,28,0,2,0,1,4,67,0
57,27,0,0,0,19,1,104,0
54,31,0,2,0,7,17,111,0
47,17,0,2,0,17,1,84,0
110,9,0,6,0,18,2,145,0
401,14,0,31,0,5,10,461,0
62,3,0,18,0,0,0,83,0
98,8,0,15,0,0,1,122,0
43,5,0,2,0,0,0,50,0
48,7,0,1,0,1,2,59,0
44,12,0,3,0,1,3,63,1
16,2,0,0,0,0,0,18,0
36,15,0,3,0,8,6,68,0
67,42,2,3,0,23,10,147,0
11,20,0,0,0,0,3,34,0
18,6,0,0,0,0,1,25,0
23,50,0,2,0,10,0,85,0
26,47,0,1,0,4,1,79,0
52,4,0,2,0,3,3,64,0
42,5,0,10,0,0,4,61,0
68,6,0,1,0,75,13,163,0
11,16,0,2,0,22,0,51,0
26,27,0,0,0,10,5,68,0
11,9,0,3,0,20,3,46,0
9,45,0,0,0,5,3,62,0
18,41,0,0,0,0,4,63,0
44,67,0,2,0,0,0,113,0
90,42,0,2,0,15,11,160,0
17,18,0,0,0,7,2,44,0
39,2,0,1,0,9,0,51,0
38,4,0,0,0,0,0,42,0
15,8,0,0,0,0,2,25,0
7,0,0,0,0,1,2,10,0
37,35,0,1,0,0,0,73,1
5,0,0,0,0,0,0,5,0
21,0,0,0,0,0,0,21,0
0,0,0,0,0,5,0,5,0
67,0,0,0,0,7,2,76,0
37,5,0,1,0,0,3,46,0
11,5,0,0,0,0,0,16,0
88,5,0,7,0,2,4,106,0
45,0,0,8,0,0,1,54,0
338,25,0,53,0,6,15,437,0
153,4,0,30,0,0,5,192,0
234,7,0,40,0,0,6,287,0
13,4,2,0,0,0,1,20,0
229,31,0,56,0,2,13,331,0
172,12,0,15,0,3,4,206,0
122,6,0,65,0,3,5,201,0
136,16,0,14,0,5,5,176,0
44,2,0,20,0,1,3,70,0
105,10,0,16,0,0,7,138,0
122,5,0,34,0,0,1,162,0
120,2,0,8,0,1,3,134,1
86,2,0,5,0,1,1,95,0
11,3,0,0,0,1,0,15,0
211,22,0,49,0,3,9,294,0
156,10,0,25,0,1,0,192,1
126,8,0,37,0,0,5,176,0
385,89,0,104,0,9,1,588,1
161,9,0,95,0,0,7,272,0
124,22,1,135,0,1,5,288,1
139,32,0,1,0,19,2,193,0
92,5,0,1,0,2,2,102,0
59,7,0,7,0,4,0,77,0
78,6,1,4,0,0,5,94,0
98,3,0,4,0,0,1,106,1
58,14,0,1,0,0,0,73,0
120,49,5,2,0,0,10,186,0
108,13,0,19,0,0,4,144,0
95,4,0,10,0,0,2,111,0
136,10,0,16,0,0,6,168,0
56,3,0,6,0,1,1,67,2
38,0,0,3,0,0,0,41,0
76,0,0,2,0,0,2,80,0
13,0,0,0,0,0,0,13,0
83,1,0,6,0,1,1,92,0
85,7,0,2,1,0,1,96,0
46,0,0,1,0,2,0,49,0
41,2,0,1,0,0,4,48,0
33,0,1,2,0,0,0,36,0
46,3,0,2,0,0,0,51,0
62,2,0,4,0,1,0,69,0
34,0,0,7,0,0,2,43,0
35,2,0,1,0,0,0,38,0
32,0,0,2,0,0,2,36,0
66,1,0,2,0,0,0,69,0
90,5,0,9,0,1,4,109,0
46,0,0,0,0,0,6,52,0
104,3,0,4,0,3,0,114,0
96,0,0,5,0,0,1,102,0
56,6,0,3,0,0,0,65,0
67,3,0,2,0,0,2,74,0
50,0,0,1,0,0,0,51,0
55,7,0,0,0,1,4,67,0
42,0,0,0,0,0,1,43,0
67,0,0,0,0,7,3,77,0
31,0,0,0,0,0,0,31,0
53,1,0,0,0,0,3,57,0
54,2,2,6,0,0,1,65,1
56,2,0,0,0,1,0,59,0
35,0,0,0,0,0,0,35,0
43,2,0,1,0,0,1,47,1
1,0,0,0,0,0,0,1,0
2,0,0,0,0,0,0,2,0
47,0,0,2,0,0,2,51,0
0,0,0,0,0,0,2,2,0
96,2,0,15,0,0,2,115,0
29,4,0,9,0,0,0,42,0
6,0,0,0,0,0,0,6,0
3,0,0,0,0,0,0,3,0
44,2,0,0,0,0,0,46,0
59,11,0,2,0,2,1,75,0
4,2,0,0,0,0,0,6,0
90,33,0,12,0,4,7,146,0
45,0,0,0,0,0,1,46,0
87,6,0,5,0,0,2,100,0
50,0,0,0,0,0,2,52,0
33,4,0,4,0,0,2,43,0
27,1,0,0,0,1,0,29,1
61,3,1,1,0,9,0,75,0
16,0,0,1,0,0,0,17,1
121,6,0,33,0,2,6,168,0
260,9,1,57,1,1,7,336,0
8,1,0,0,0,0,0,9,0
124,2,0,2,0,0,1,129,0
334,27,4,70,0,16,14,465,0
83,3,0,6,0,1,4,97,0
0,1,0,0,0,0,0,1,0
40,5,0,3,0,0,0,48,0
7,1,0,0,0,0,0,8,0
21,0,1,0,0,0,0,22,0
22,0,0,0,0,0,0,22,0
21,0,0,1,0,0,0,22,0
20,1,0,0,0,1,0,22,1
10,0,0,0,0,1,0,11,0
80,5,0,2,0,0,1,88,0
106,0,1,0,0,0,1,108,1
112,1,2,3,0,0,4,122,0
127,2,2,3,0,1,2,137,1
111,5,0,0,0,1,0,117,0
62,0,0,0,0,0,1,63,0
84,3,1,3,0,0,0,91,0
44,0,0,0,0,0,0,44,0
155,1,0,6,0,0,5,167,0
156,3,1,4,0,0,5,169,0
2,0,0,0,0,1,0,3,0
102,1,0,1,0,0,2,106,0
6,0,0,0,0,0,0,6,0
21,0,0,1,0,0,0,22,0
17,3,0,0,0,0,0,20,0
199,3,1,5,0,0,4,212,0
88,4,0,2,0,2,1,97,0
93,1,0,2,0,3,0,99,0
201,6,0,8,0,0,3,218,0
28,0,1,0,0,1,1,31,0
72,8,0,1,0,1,1,83,1
39,0,0,3,0,0,0,42,0
20,0,0,0,0,0,0,20,0
126,3,0,1,0,1,1,132,1
46,0,0,1,0,1,1,49,1
154,3,0,5,0,0,5,167,0
61,0,0,0,0,2,2,65,0
50,0,0,3,0,0,0,53,0
2,0,0,0,0,0,0,2,0
19,0,0,0,0,0,1,20,0
4,0,0,0,0,0,0,4,0
63,0,0,3,0,0,0,66,0
24,2,0,0,0,1,0,27,0
10,0,0,0,0,0,0,10,0
4,0,1,0,0,0,0,5,0
14,1,0,0,0,0,0,15,0
12,0,0,0,0,0,0,12,0
15,0,0,0,1,0,0,16,0
59,1,0,0,0,0,4,64,0
48,5,1,3,0,2,1,60,1
48,6,1,4,0,0,1,60,0
109,1,1,0,0,1,0,112,0
64,1,0,1,0,0,0,66,0
41,2,0,0,0,1,0,44,1
40,0,0,1,0,0,1,42,1
39,4,0,0,0,0,4,47,0
30,5,0,1,0,0,0,36,0
18,0,0,0,0,0,3,21,0
89,0,1,0,0,0,0,90,1
92,11,1,3,0,1,1,109,0
77,2,0,2,0,4,6,91,0
50,4,0,0,0,1,0,55,0
17,6,0,0,0,0,0,23,0
15,1,0,0,0,1,3,20,0
67,1,1,2,0,0,3,74,1
72,0,0,0,0,0,2,74,0
73,0,0,1,0,0,0,74,0
25,1,0,3,0,1,1,31,1
59,1,0,0,0,0,2,62,0
28,1,0,2,0,0,1,32,0
24,5,0,0,0,0,1,30,0
51,2,0,4,0,0,1,58,0
38,0,0,7,0,0,1,46,0
28,2,0,0,0,0,0,30,0
47,1,0,0,0,0,1,49,0
67,2,0,2,0,2,1,74,1
34,5,0,0,0,0,0,39,0
56,4,0,2,0,7,1,70,1
37,2,0,2,0,0,3,44,0
48,1,0,2,0,1,0,52,0
31,3,0,2,0,0,5,41,0
31,0,0,0,0,0,0,31,0
74,2,0,1,0,0,3,80,0
90,67,0,4,0,2,5,168,0
61,43,0,1,0,1,5,111,0
39,2,0,0,0,0,0,41,0
59,5,0,0,0,0,0,64,0
88,1,0,1,0,0,5,95,2
110,4,0,2,0,1,4,121,1
74,0,0,1,0,0,0,75,0
77,2,0,4,0,0,4,87,0
106,0,0,2,0,0,1,109,1
114,5,1,1,0,3,2,126,0
77,11,0,1,0,3,1,93,0
62,0,0,1,0,0,1,64,1
60,2,0,0,0,0,0,62,0
79,5,0,5,0,0,0,89,0
30,4,0,1,0,0,0,35,0
84,2,0,1,0,2,0,89,0
184,7,0,2,0,3,4,200,0
116,7,0,3,0,0,2,128,0
97,1,0,1,0,1,1,101,1
16,0,0,0,0,0,0,16,0
57,2,0,0,0,0,2,61,0
101,0,0,3,0,3,5,112,0
75,3,0,1,0,0,1,80,0
120,8,0,5,0,0,3,136,0
10,0,0,1,0,0,0,11,0
109,1,0,2,0,0,1,113,1
84,1,0,0,0,4,0,89,0
39,1,0,3,0,1,0,44,0
64,0,0,2,0,0,0,66,0
47,5,1,5,0,0,1,59,1
65,2,0,4,0,0,1,72,0
75,1,0,2,0,0,1,79,0
50,0,0,2,0,0,1,53,0
59,0,0,4,0,0,6,69,0
57,1,2,7,0,0,1,68,1
15,0,0,3,0,0,1,19,0
66,0,0,8,0,1,2,77,0
28,1,0,2,0,0,0,31,0
40,23,1,0,0,0,2,66,0
27,2,0,2,0,0,1,32,0
2,1,0,0,0,0,0,3,0
2,1,0,0,0,0,0,3,0
13,1,0,0,0,0,0,14,1
9,0,0,1,0,1,0,11,0
24,0,0,0,0,0,0,24,0
28,1,0,0,1,0,0,30,0
50,16,0,1,0,0,4,71,0
85,8,0,0,0,0,3,96,0
55,34,0,4,0,1,1,95,2
40,2,0,1,0,0,2,45,0
21,16,0,0,0,0,0,37,0
22,0,0,3,0,1,0,26,0
34,4,0,0,0,0,3,41,0
22,0,3,0,0,0,3,28,0
18,3,0,0,0,0,3,24,0
2,1,0,0,0,0,0,3,1
11,11,0,0,0,1,1,24,0
69,29,0,1,0,1,4,104,0
39,1,0,2,0,0,1,43,2
42,5,0,4,0,1,0,52,0
5,0,0,0,0,0,1,6,0
9,10,0,2,0,0,3,24,0
15,2,0,0,0,0,3,20,0
9,0,0,1,0,0,0,10,0
28,12,0,0,0,1,2,43,0
62,1,1,1,0,0,0,65,0
9,25,0,1,0,0,1,36,0
8,0,0,0,0,0,0,8,0
96,3,0,0,0,1,2,102,0
64,2,0,1,0,0,0,67,0
3,1,1,1,0,0,0,6,0
45,9,0,1,0,1,1,57,0
53,3,0,4,0,0,4,64,0
21,0,0,2,0,0,1,24,0
16,1,0,1,0,1,1,20,2
41,3,0,0,0,1,3,48,0
4,0,0,0,0,0,0,4,0
46,13,0,3,0,0,3,65,0
19,8,0,0,0,0,0,27,0
130,7,0,2,0,1,4,144,1
6,0,0,0,0,0,0,6,0
111,9,0,5,0,4,4,133,0
0,2,0,0,0,0,0,2,0
0,30,0,0,0,0,0,30,0
0,25,0,3,0,0,0,28,0
6,14,0,0,0,0,4,24,0
25,28,1,0,0,0,5,59,0
7,56,0,0,0,0,2,65,0
9,12,0,0,0,0,0,21,0
1,19,0,0,0,0,0,20,0
12,24,0,3,0,0,1,40,1
1,57,0,5,0,1,1,65,0
0,50,0,0,0,0,0,50,0
7,13,0,0,0,0,0,20,0
3,21,2,0,0,0,5,31,0
7,27,3,0,0,0,0,37,0
0,26,0,0,0,0,2,28,0
6,15,0,0,0,0,3,24,0
17,6,0,0,0,0,0,23,0
3,51,0,0,0,0,0,54,0
0,24,0,0,0,0,2,26,0
0,20,0,0,0,0,0,20,0
5,29,0,0,1,0,6,41,0
0,18,0,0,0,0,0,18,0
1,0,0,0,0,0,0,1,0
1,0,0,0,0,0,0,1,0
1,4,0,0,0,0,0,5,0
10,22,0,0,0,0,1,33,0
0,36,0,0,0,0,0,36,0
0,7,0,0,0,0,0,7,0
0,7,0,0,0,0,0,7,0
2,45,0,0,0,0,0,47,0
7,50,0,0,0,0,1,58,0
0,14,0,0,0,0,0,14,0
3,49,1,3,0,0,1,57,1
5,42,0,0,0,1,0,48,0
0,30,0,0,0,0,0,30,0
1,1,0,0,0,0,0,2,0
1,28,0,0,0,0,0,29,0
2,45,5,0,0,0,1,53,0
3,31,0,0,0,0,2,36,0
2,9,0,0,0,0,0,11,0
4,59,0,0,0,0,0,63,0
10,44,4,0,0,0,1,59,1
0,3,0,0,0,0,0,3,0
2,48,0,0,0,0,0,50,0
1,8,0,0,0,4,1,14,0
0,27,0,0,0,0,0,27,0
0,5,0,0,0,0,0,5,0
0,4,0,0,0,0,0,4,0
0,22,0,0,0,1,4,27,0
12,31,0,0,0,0,0,43,0
14,44,0,0,0,0,4,62,0
2,38,0,0,0,0,1,41,0
18,17,0,0,0,0,1,36,0
7,36,0,0,0,0,4,47,0
3,59,0,3,0,0,0,65,0
4,60,0,0,0,0,3,67,0
9,77,0,0,0,0,0,86,0
0,6,0,0,0,0,0,6,0
1,9,0,0,0,0,2,12,0
1,6,0,3,0,0,0,10,0
8,47,0,0,0,0,0,55,0
1,18,0,0,0,0,0,19,1
4,43,0,0,0,0,1,48,1
19,95,0,0,0,1,5,120,1
0,22,0,0,0,0,0,22,0
2,16,0,0,0,0,1,19,1
13,27,0,0,0,0,4,44,0
5,49,0,0,0,0,1,55,1
7,19,0,0,0,0,0,26,0
0,32,3,0,0,0,0,35,0
1,19,0,0,0,0,0,20,0
5,49,0,0,0,0,3,57,0
0,28,0,0,0,0,3,31,0
0,35,3,2,0,3,0,43,0
1,18,0,0,0,0,0,19,0
0,20,0,0,0,0,0,20,0
1,27,0,0,0,0,0,28,0
4,40,0,5,0,0,0,49,0
0,64,0,3,0,0,1,68,0
9,28,0,0,0,0,0,37,0
1,75,0,0,0,0,0,76,0
5,57,0,0,0,0,4,66,0
0,47,0,0,0,0,3,50,0
15,45,0,6,0,0,0,66,0
0,29,0,0,0,0,1,30,0
3,20,0,0,0,3,0,26,0
5,49,0,0,0,0,0,54,0
5,87,0,0,0,0,3,95,0
31,239,0,0,0,1,6,277,0
4,44,0,6,0,0,0,54,0
2,52,0,0,0,0,0,54,0
1,22,0,0,0,0,1,24,1
11,11,0,0,0,11,0,33,0
7,0,0,0,0,3,0,10,0
0,3,0,0,0,10,1,14,0
6,0,0,0,0,0,0,6,0
31,54,0,0,0,18,4,107,0
8,4,1,0,0,11,0,24,0
5,8,2,0,0,0,0,15,0
0,5,0,0,0,0,4,9,0
0,18,0,0,0,3,0,21,0
0,0,0,12,0,0,0,12,0
0,4,0,0,0,0,0,4,0
1,16,0,0,0,0,0,17,0
7,0,0,0,0,0,0,7,0
2,16,0,0,0,0,0,18,0
0,11,0,0,0,0,0,11,0
0,6,0,0,0,0,0,6,0
0,5,0,0,0,0,0,5,0
0,11,0,0,0,0,0,11,0
0,2,0,0,0,0,0,2,0
10,10,0,0,0,0,1,21,0
6,14,0,0,0,0,0,20,0
0,10,0,0,0,0,0,10,0
8,91,0,0,0,1,0,100,0
7,76,0,1,0,0,7,91,0
18,14,0,0,0,9,7,48,0
21,1,0,0,0,22,0,44,0
0,21,0,0,0,0,0,21,0
0,3,0,0,0,0,0,3,0
0,0,0,0,0,0,2,2,0
2,0,0,0,0,0,0,2,0
4,28,0,0,0,0,0,32,0
7,33,0,0,0,0,0,40,0
17,350,0,0,0,0,34,401,0
10,59,0,0,0,0,6,75,0
1,27,0,0,0,0,0,28,0
4,33,0,0,0,0,2,39,0
3,43,0,0,0,0,1,47,0
4,27,0,0,0,0,0,31,0
3,17,0,0,0,0,0,20,0
7,63,0,0,0,0,7,77,0
0,1,0,1,0,0,0,2,0
1,24,0,0,0,0,1,26,0
1,17,0,0,0,0,0,18,0
0,31,0,0,0,0,0,31,0
8,49,0,0,0,0,12,69,0
2,48,0,0,0,0,0,50,0
0,24,0,0,0,0,1,25,0
14,38,0,0,0,2,2,56,0
2,24,3,0,0,0,1,30,1
2,53,0,0,0,0,3,58,0
2,38,0,0,0,0,5,45,0
4,25,0,0,0,0,7,36,0
12,11,1,1,0,0,0,25,1
25,77,0,0,0,2,0,104,0
39,52,0,0,0,0,6,97,0
3,47,0,0,0,0,0,50,0
1,39,0,4,0,0,1,45,0
1,27,0,0,0,0,0,28,0
4,26,0,0,0,0,1,31,0
3,21,0,0,0,0,0,24,0
8,10,0,0,0,0,2,20,0
1,7,0,1,0,0,0,9,0
3,0,0,0,0,0,0,3,0
3,13,0,0,1,1,5,23,0
15,44,0,0,0,0,0,59,0
15,223,0,0,0,0,8,246,0
18,15,0,1,0,0,3,37,0
15,104,0,0,0,0,1,120,0
10,23,0,0,0,0,0,33,0
7,10,1,0,0,0,3,21,0
12,6,0,0,0,1,0,19,0
5,6,0,0,0,0,0,11,0
17,3,0,2,0,0,1,23,0
11,32,0,0,0,0,0,43,0
19,65,0,0,0,2,0,86,0
6,9,0,0,0,0,2,17,0
0,16,0,0,0,0,0,16,0
2,5,0,0,0,0,0,7,0
109,98,0,5,0,0,3,215,0
16,49,2,0,0,0,6,73,0
15,50,0,0,0,0,0,65,0
11,93,0,3,0,0,11,118,0
10,70,0,0,0,2,9,91,0
5,82,0,0,0,0,4,91,0
8,58,1,0,0,1,13,81,1
11,43,1,0,0,1,0,56,0
24,34,6,0,0,0,6,70,0
18,59,1,1,0,6,2,87,0
11,33,0,0,0,3,2,49,0
5,25,0,0,0,0,0,30,0
18,19,0,0,0,3,0,40,0
7,15,2,0,0,0,0,24,0
17,34,0,0,0,0,3,54,0
30,20,0,0,0,1,0,51,0
1,1,1,0,0,0,0,3,1
2,6,1,0,0,0,0,9,0
203,196,1,1,0,1,2,404,2
2,38,0,0,0,0,0,40,0
0,18,0,0,0,0,0,18,0
26,26,0,0,0,0,0,52,0
15,18,0,0,0,4,1,38,1
13,26,2,0,0,0,2,43,0
4,12,0,0,0,0,0,16,0
4,26,0,0,0,2,0,32,0
34,81,0,0,0,0,5,120,0
11,32,1,0,0,0,2,46,0
18,32,0,0,0,0,0,50,0
4,25,0,2,0,0,3,34,0
0,51,0,0,0,5,0,56,0
2,36,1,0,0,0,1,40,0
0,12,0,0,0,0,0,12,0
8,12,0,0,0,0,0,20,0
137,238,1,3,0,199,26,604,0
3,0,0,0,0,21,0,24,0
31,12,2,0,0,128,5,178,0
5,0,0,0,0,18,0,23,0
0,0,0,0,0,18,0,18,0
15,1,0,0,0,31,0,47,1
0,0,0,0,0,12,0,12,0
1,0,2,0,0,0,0,3,0
11,0,0,0,0,5,0,16,0
0,3,0,0,0,10,0,13,0
1,4,0,0,0,0,1,6,0
7,0,0,0,0,0,0,7,0
1,8,0,0,0,0,0,9,0
7,2,0,0,0,1,0,10,0
8,49,0,0,0,0,0,57,0
0,0,0,0,0,9,0,9,0
6,1,0,0,0,0,0,7,0
41,286,1,0,0,100,25,453,0
3,3,0,0,0,0,0,6,0
3,0,0,0,0,12,1,16,0
0,0,0,0,0,9,0,9,0
5,0,0,0,0,14,0,19,0
0,0,0,0,0,18,0,18,0
0,0,0,0,0,17,0,17,0
7,0,1,0,0,7,3,18,0
9,0,0,0,0,2,0,11,0
3,0,0,0,0,14,0,17,0
6,58,0,0,0,3,0,67,0
15,35,0,0,0,0,0,50,0
12,28,0,0,0,0,9,49,0
4,13,0,0,0,0,0,17,0
6,29,1,0,0,0,4,40,0
5,28,0,0,0,0,5,38,0
45,18,0,0,0,1,7,71,0
8,29,0,17,0,0,2,56,0
83,340,0,0,3,11,24,461,0
21,45,1,1,8,10,11,97,0
14,22,0,0,0,0,3,39,0
60,150,0,4,0,7,16,237,0
14,23,0,0,0,0,0,37,0
13,44,0,0,0,15,0,72,0
50,218,3,1,0,12,11,295,0
3,59,4,0,0,0,1,67,0
10,38,5,0,0,6,2,61,0
67,136,1,1,0,10,7,222,0
89,108,1,4,0,64,4,270,0
29,40,0,5,0,6,7,87,0
18,113,0,1,0,5,4,141,0
21,148,0,2,0,9,7,187,0
31,34,1,1,0,0,2,69,1
79,165,1,0,0,7,11,263,0
42,81,1,0,0,0,4,128,1
11,25,0,2,0,0,1,39,1
14,58,0,2,0,0,5,79,0
69,76,1,0,0,6,7,159,0
28,40,1,2,1,0,0,72,0
62,91,2,3,0,9,11,178,0
47,171,0,0,0,1,19,238,0
39,112,0,4,0,2,5,162,0
39,109,0,0,0,2,21,171,0
21,39,0,0,0,5,0,65,0
21,40,0,1,0,4,0,66,0
27,18,0,0,0,1,0,46,0
38,10,0,0,0,0,0,48,0
57,5,0,0,0,0,0,62,0
57,0,0,1,0,0,0,58,0
127,12,0,3,0,1,3,146,0
46,0,0,0,0,0,0,46,0
56,0,0,0,0,0,0,56,0
43,0,0,0,0,0,0,43,0
42,0,0,0,0,0,1,43,0
44,8,0,1,0,0,1,54,0
39,0,0,0,0,0,0,39,0
32,6,0,0,0,0,0,38,0
26,1,0,0,0,0,0,27,0
37,4,0,0,0,0,2,43,0
21,15,0,0,0,10,0,46,0
8,25,0,3,0,0,1,37,0
27,4,0,0,0,0,1,32,1
70,11,2,1,0,0,3,87,0
79,9,0,1,0,0,0,89,0
107,10,0,0,0,0,0,117,0
3,0,0,0,0,0,0,3,0
22,8,0,0,0,0,0,30,0
14,5,0,0,0,0,0,19,0
39,10,0,0,0,0,0,49,0
41,0,0,0,0,0,0,41,0
44,0,0,0,0,0,0,44,0
41,5,0,0,0,0,3,49,0
41,0,0,0,0,0,0,41,0
30,14,0,0,0,0,0,44,0
24,5,0,1,0,0,2,32,0
1,15,1,0,0,0,0,17,0
7,18,0,0,0,0,0,25,0
31,13,0,1,0,3,0,48,0
29,28,0,0,0,6,1,64,0
25,17,0,0,0,1,0,43,0
39,28,0,0,1,1,0,69,0
57,21,0,0,0,2,1,81,0
54,19,0,1,0,3,1,78,0
49,15,1,0,0,3,0,68,0
40,0,0,0,0,0,0,40,0
23,3,0,0,0,0,0,26,0
10,2,0,0,0,0,0,12,0
11,6,0,0,0,0,0,17,0
3,5,0,0,0,0,0,8,0
36,27,0,2,0,0,7,72,0
25,31,0,0,0,1,2,59,0
5,32,0,0,0,0,2,39,0
14,21,0,0,0,6,0,41,0
12,125,1,2,0,0,19,159,0
17,45,0,2,0,0,1,65,0
5,16,0,3,0,0,0,24,0
20,55,0,5,0,0,2,82,0
24,37,1,3,0,5,11,81,0
46,58,0,0,0,3,0,107,0
43,103,0,0,0,0,2,148,0
27,46,0,0,0,15,14,102,0
2,87,0,0,0,0,1,90,0
21,91,0,0,0,1,8,121,0
3,23,0,1,0,0,6,33,0
22,30,0,4,5,2,0,63,0
40,34,0,0,0,7,0,81,0
30,31,0,1,0,12,0,74,0
26,32,0,0,0,0,4,62,0
22,16,0,4,0,2,9,53,0
16,20,0,6,0,2,1,45,0
30,45,0,0,0,4,14,93,0
36,47,0,6,0,6,0,95,0
28,63,0,0,0,0,4,95,0
8,28,0,0,0,0,6,42,0
29,14,0,0,0,0,3,46,0
16,21,0,0,0,3,0,40,0
14,26,0,0,0,0,0,40,0
18,20,0,1,0,2,0,41,0
6,20,0,2,0,5,1,34,1
20,13,0,0,0,0,6,39,0
17,12,0,0,0,0,3,32,0
18,16,0,0,0,0,0,34,0
10,60,0,0,0,0,3,73,0
7,88,1,1,0,0,6,103,0
33,13,0,1,0,0,2,49,0
7,27,0,0,0,0,9,43,0
6,27,0,0,0,0,2,35,0
15,10,0,0,0,0,0,25,0
13,12,0,0,0,0,1,26,0
39,13,0,0,0,0,0,52,0
44,14,0,0,0,0,6,64,0
43,15,1,1,0,0,2,62,0
79,0,0,0,0,0,0,79,0
69,0,1,1,0,4,0,75,0
28,16,0,1,0,0,5,50,0
50,16,0,1,0,0,5,72,0
24,15,0,0,0,0,0,39,0
108,28,3,3,0,0,3,145,0
57,7,0,0,0,4,0,68,0
35,12,0,0,0,0,2,49,0
32,14,0,0,0,2,0,48,0
13,17,0,0,0,11,0,41,0
13,82,0,1,0,3,2,101,0
31,2,0,0,0,0,0,33,0
48,35,0,0,0,0,0,83,0
31,18,0,0,0,0,1,50,0
39,17,0,1,0,0,5,62,0
28,18,0,0,0,0,2,48,0
13,9,0,0,0,0,0,22,0
48,21,0,0,0,0,0,69,0
20,58,0,7,0,0,0,85,0
36,95,1,0,0,1,3,136,0
18,35,0,2,0,0,4,59,0
37,28,0,0,0,0,6,71,0
32,18,0,1,0,0,2,53,0
67,19,0,0,0,0,2,88,0
25,0,0,0,0,0,0,25,0
39,3,0,2,0,0,0,44,0
31,123,0,3,2,12,5,176,0
7,21,0,0,0,0,2,30,0
16,41,0,1,0,1,1,60,1
83,48,1,2,0,7,5,146,0
18,44,0,0,0,0,1,63,0
36,39,0,0,0,0,0,75,0
22,9,0,0,0,0,1,32,1
30,34,0,1,0,2,0,67,0
61,46,0,0,0,0,2,109,0
52,5,1,1,0,5,0,64,0
80,16,0,0,0,5,3,104,0
27,10,0,1,0,3,1,42,1
10,7,0,0,0,0,0,17,0
21,15,0,0,0,0,0,36,0
19,24,0,0,0,5,1,49,0
26,2,0,1,0,0,1,30,0
9,19,0,1,0,3,2,34,0
15,5,0,0,0,0,0,20,0
4,9,0,0,0,0,0,13,0
3,28,0,0,0,0,0,31,0
26,63,1,0,0,0,1,91,0
18,58,0,1,0,0,4,81,0
14,53,0,1,0,0,0,68,0
25,31,0,0,0,0,6,62,0
18,46,0,3,0,0,6,73,0
50,33,0,0,0,4,7,94,0
23,29,0,1,0,6,0,59,0
19,13,0,2,1,0,2,37,0
52,227,0,4,1,5,23,312,1
15,16,1,0,0,0,0,32,0
32,38,1,0,0,1,4,76,1
37,42,0,1,0,0,1,81,0
28,37,4,0,0,0,3,72,0
25,44,0,0,0,4,1,74,0
31,37,0,0,0,0,4,72,0
31,40,0,0,0,11,4,86,0
30,142,0,2,0,7,4,185,0
18,59,0,0,0,0,1,78,0
10,41,0,1,0,0,0,52,0
36,218,0,2,0,12,11,279,0
25,28,0,0,0,5,0,58,0
9,0,0,0,0,0,0,9,0
34,10,0,0,0,0,2,46,0
22,22,0,1,0,1,0,46,1
20,3,0,0,0,1,0,24,0
41,45,0,0,0,0,0,86,0
17,20,0,0,0,0,4,41,0
29,15,0,0,0,0,2,46,0
15,20,0,0,0,0,4,39,0
64,17,0,0,0,0,3,84,0
15,8,0,0,0,0,0,23,0
51,36,0,0,0,1,0,88,0
16,14,0,0,0,0,0,30,0
29,45,0,0,0,0,0,74,0
5,12,0,0,0,0,1,18,0
7,23,0,5,0,0,0,35,0
35,29,0,0,0,0,6,70,0
6,25,0,0,0,0,0,31,0
17,17,0,0,0,0,0,34,0
21,8,0,0,0,0,0,29,0
12,8,0,0,0,0,0,20,0
28,11,0,0,0,0,0,39,0
4,37,0,0,0,0,0,41,0
12,44,2,1,0,0,0,59,0
29,73,1,5,0,0,1,109,1
3,19,0,0,0,0,1,23,1
54,19,0,2,0,0,0,75,0
21,27,0,3,0,0,6,57,0
13,9,0,0,0,0,2,24,0
427,65,0,0,0,0,1,493,1
48,22,0,0,0,3,9,82,0
20,20,0,0,0,0,0,40,0
27,14,0,0,0,0,0,41,0
14,12,0,4,0,0,0,30,0
8,2,0,0,0,0,0,10,0
23,21,0,0,0,0,1,45,0
20,3,0,2,0,0,0,25,0
34,7,0,2,0,0,3,46,0
52,13,1,0,0,0,3,69,0
44,19,1,0,0,1,11,76,1
50,17,0,0,0,0,1,68,0
18,18,0,4,0,0,0,40,0
4,29,0,0,0,0,0,33,0
10,36,0,0,0,0,3,49,0
0,13,0,0,0,0,2,15,0
3,34,0,0,0,0,0,37,0
3,41,0,0,0,0,4,48,0
2,40,0,0,0,0,7,49,0
1,18,0,0,0,0,0,19,0
0,4,0,0,0,0,3,7,0
0,10,0,0,0,1,0,11,0
0,41,0,0,0,0,2,43,0
1,32,0,0,0,0,0,33,0
0,9,0,0,0,0,0,9,0
2,32,0,1,0,0,3,38,0
0,29,0,0,0,1,0,30,0
3,17,0,0,0,0,1,21,0
8,14,0,0,0,0,0,22,0
0,4,0,0,0,0,0,4,0
1,14,0,0,0,0,0,15,0
4,95,1,0,0,0,0,100,0
1,63,0,0,0,0,1,65,1
4,86,1,0,0,0,1,92,1
0,1,0,0,0,0,0,1,0
0,77,2,0,0,0,0,79,0
1,26,0,0,0,0,1,28,2
2,35,0,0,0,0,0,37,0
3,39,0,0,0,0,0,42,0
6,77,0,0,0,0,7,90,0
1,11,0,0,0,0,0,12,0
4,42,0,0,0,0,3,49,0
2,44,0,0,0,0,0,46,0
5,32,0,0,0,0,0,37,0
4,263,0,0,0,8,5,280,0
0,3,0,0,0,0,0,3,0
0,2,0,0,0,0,0,2,0
4,134,0,1,0,0,6,145,0
3,174,0,0,4,4,12,197,0
0,1,0,0,0,0,0,1,1
1,0,0,0,0,0,0,1,0
4,177,0,0,0,0,9,190,0
3,79,6,0,0,0,0,88,0
3,18,0,0,0,0,2,23,0
0,24,0,0,0,0,0,24,0
10,18,0,0,0,0,0,28,0
8,39,0,0,0,0,8,55,0
16,60,0,2,0,3,14,95,0
33,40,0,3,0,0,7,83,0
0,8,0,0,0,0,0,8,0
30,3,0,0,0,0,4,37,0
16,2,0,0,0,0,3,21,0
25,28,1,2,0,1,0,57,0
21,36,0,0,0,0,1,58,0
25,40,4,0,0,0,3,72,0
4,3,0,0,0,0,0,7,0
2,36,0,0,0,0,0,38,0
0,132,0,0,23,0,0,155,0
11,252,1,0,10,5,21,300,0
1,0,0,0,0,0,0,1,1
0,96,0,0,3,0,0,99,0
29,470,0,17,4,8,15,543,0
0,0,0,0,0,0,1,1,0
1,103,0,0,8,0,0,112,0
0,2,0,0,0,0,0,2,0
4,53,0,0,0,0,6,63,0
0,59,0,0,0,0,0,59,0
22,485,2,2,3,3,11,528,0
3,62,0,0,0,0,8,73,0
1,24,0,0,0,0,0,25,0
3,60,0,0,0,0,0,63,0
1,43,1,0,0,0,0,45,1
2,63,0,0,0,0,6,71,0
7,66,1,1,0,1,2,78,0
3,61,0,0,0,0,6,70,0
3,29,0,0,0,3,0,35,0
2,0,1,0,0,0,0,3,0
0,3,0,0,0,0,0,3,0
13,0,0,0,0,0,1,14,1
38,1,0,0,0,0,0,39,0
16,1,0,0,0,0,2,19,0
40,0,0,0,0,1,3,44,0
65,57,1,5,0,0,5,133,0
9,0,0,0,0,0,0,9,0
52,3,0,4,0,0,3,62,0
11,38,0,0,0,0,1,50,0
20,0,0,0,0,0,0,20,0
33,0,0,2,0,0,1,36,0
20,0,0,2,0,0,1,23,0
36,1,0,0,0,0,1,38,1
33,2,1,1,0,0,1,38,0
21,3,0,1,0,0,0,25,0
20,2,0,0,0,0,3,25,0
3,0,0,0,0,0,0,3,0
1,12,0,1,0,0,4,18,0
1,0,0,0,0,0,0,1,0
16,41,0,1,0,7,3,68,0
0,1,0,0,0,0,0,1,0
7,1,0,0,0,0,0,8,1
1,0,0,0,0,0,0,1,0
25,0,0,4,0,0,0,29,0
217,13,0,16,0,2,10,258,0
2,0,0,0,0,0,0,2,0
118,2,0,14,0,0,5,139,0
2,0,0,0,0,0,0,2,0
49,0,0,3,0,1,0,53,0
15,1,0,0,0,0,0,16,0
119,9,0,6,0,0,3,137,0
2,0,0,0,0,0,0,2,0
72,8,0,1,0,0,4,85,1
67,2,0,4,0,0,0,73,0
45,9,0,4,0,1,4,63,1
38,0,0,3,0,0,0,41,0
12,0,0,0,0,0,0,12,0
51,7,0,2,0,1,0,61,0
69,1,1,7,0,1,0,79,0
1,1,0,0,0,0,0,2,0
6,3,0,0,0,1,0,10,0
14,0,0,1,0,0,0,15,0
8,7,0,0,0,0,0,15,0
79,60,0,0,0,0,1,140,0
1,0,0,1,0,0,1,3,0
0,1,0,0,0,0,0,1,0
0,23,0,1,0,0,1,25,0
0,13,1,0,0,0,0,14,0
1,39,0,0,0,0,1,41,0
1,18,0,0,0,0,0,19,0
7,15,0,1,0,0,0,23,1
0,8,0,1,0,0,1,10,1
15,28,0,0,0,0,4,47,0
14,0,0,0,0,0,0,14,0
28,47,0,2,0,0,5,82,0
4,0,0,0,0,0,0,4,0
10,1,0,0,0,0,0,11,0
24,30,1,0,0,0,0,55,0
13,35,0,0,0,0,2,50,0
8,3,0,2,0,0,0,13,0
142,13,1,12,0,3,9,180,0
4,11,0,0,0,0,0,15,0
165,16,1,4,0,3,5,194,0
124,135,2,0,0,3,13,277,0
18,10,0,0,0,1,2,31,0
16,1,0,0,0,0,0,17,0
18,43,0,0,0,0,3,64,0
925,119,5,59,0,68,30,1206,0
112,0,0,6,0,1,1,120,0
2,0,0,0,0,0,0,2,0
320,13,0,1,0,0,0,334,0
42,2,0,5,0,0,0,49,0
44,4,0,0,0,1,3,52,0
19,0,0,0,0,1,1,21,0
17,1,0,2,0,0,0,20,0
40,1,0,2,0,0,1,44,1
38,1,0,1,0,0,0,40,0
38,1,0,0,0,0,1,40,1
38,1,0,1,0,0,3,43,0
24,0,0,0,0,0,0,24,0
82,2,0,2,0,1,1,88,1
60,0,0,4,0,0,0,64,0
0,16,0,0,0,0,0,16,0
13,78,1,0,0,0,0,92,0
16,73,1,1,0,0,8,99,0
1,40,0,0,0,0,0,41,0
38,89,0,2,0,1,2,132,0
10,89,0,0,0,2,8,109,0
17,27,0,0,0,0,3,47,0
24,46,0,0,0,2,3,75,0
9,4,0,0,0,0,1,14,1
4,32,0,0,0,0,5,41,0
3,45,0,0,0,0,2,50,0
1,11,0,0,0,0,0,12,1
8,36,2,0,0,0,7,53,0
10,40,0,0,0,1,1,52,0
1,46,0,0,0,0,2,49,0
0,67,0,0,0,0,6,73,0
8,30,0,0,0,0,2,40,0
4,32,0,0,0,0,1,37,0
1,17,0,0,0,0,0,18,0
2,29,2,0,0,0,0,33,0
2,25,0,0,0,0,9,36,0
0,36,0,0,0,0,2,38,0
1,40,0,0,0,0,5,46,0
0,16,0,0,0,0,0,16,0
4,35,0,0,0,0,0,39,0
9,4,0,0,0,0,0,13,0
2,10,0,0,0,0,0,12,0
0,2,0,0,0,0,0,2,0
0,17,0,0,0,0,0,17,0
0,5,0,0,0,0,0,5,0
23,58,0,1,0,0,2,84,0
2,16,0,0,0,0,0,18,0
28,5,0,0,0,0,0,33,0
9,0,0,0,0,0,0,9,0
30,3,0,0,0,0,0,33,0
19,41,0,0,0,0,5,65,0
15,112,0,0,0,0,3,130,0
28,59,0,0,0,0,2,89,0
21,61,0,1,0,2,1,86,1
10,36,0,0,0,0,1,47,0
1,2,0,0,0,0,0,3,0
9,2,0,0,0,1,0,12,0
9,27,0,0,0,0,3,39,0
2,9,0,0,0,0,4,15,0
5,28,0,0,0,0,4,37,0
20,39,0,0,0,1,9,69,0
22,0,0,0,0,0,0,22,0
23,0,0,0,0,0,0,23,0
16,0,0,0,0,0,0,16,0
14,41,0,0,0,0,1,56,0
16,51,0,1,0,0,2,70,0
17,67,0,0,0,0,1,85,0
17,59,5,0,0,0,8,89,0
57,88,1,0,0,0,4,150,0
6,19,0,0,0,0,0,25,0
5,26,0,0,0,0,0,31,0
1,12,0,1,0,1,4,19,0
0,3,0,0,0,0,0,3,0
0,1,0,0,0,0,0,1,0
4,0,0,0,0,0,0,4,0
14,41,0,5,0,1,0,61,0
6,50,0,1,0,0,1,58,1
7,23,0,0,0,5,0,35,0
4,46,0,0,0,0,3,53,0
2,21,0,0,0,0,3,26,0
25,47,0,0,0,0,3,75,0
10,25,0,1,0,1,2,39,0
1,37,0,1,0,0,0,39,0
13,50,0,0,0,0,7,70,0
21,43,0,0,0,0,3,67,0
42,63,0,0,0,0,19,124,0
4,1,0,4,0,0,0,9,0
6,46,0,0,0,0,2,54,0
15,14,0,3,0,0,5,37,0
23,32,0,0,0,0,2,57,0
0,14,0,0,0,0,1,15,0
0,2,0,0,0,0,0,2,0
1,0,0,0,0,1,1,3,0
3,0,0,0,0,0,0,3,0
4,1,0,0,0,0,0,5,0
5,10,0,0,0,0,0,15,0
34,109,0,2,0,0,3,148,0
0,6,0,0,0,0,0,6,0
0,3,0,0,0,0,0,3,0
1,4,0,0,0,0,1,6,0
15,26,0,0,0,0,0,41,0
24,54,2,1,0,0,9,90,0
50,43,0,1,0,0,2,96,0
16,10,0,0,0,0,1,27,1
16,63,0,0,0,0,0,79,0
17,41,1,0,0,1,1,61,0
0,17,0,0,0,0,0,17,0
31,63,1,1,0,0,3,99,1
28,26,0,1,0,3,10,68,0
73,125,2,0,0,1,6,207,0
16,42,0,0,0,0,6,64,0
24,34,3,0,0,0,1,62,1
18,15,0,0,0,0,3,36,0
6,65,4,0,0,0,4,79,0
18,4,0,0,0,0,0,22,0
4,13,0,0,0,0,0,17,0
2,0,0,0,0,0,0,2,0
33,20,0,0,0,1,4,58,0
19,5,0,0,0,0,0,24,0
11,2,0,0,0,0,0,13,0
9,7,0,0,0,0,1,17,0
10,5,0,0,0,0,0,15,0
12,0,0,0,0,0,0,12,0
4,0,0,0,0,0,2,6,0
3,0,0,0,0,0,0,3,0
6,1,0,0,0,0,0,7,0
11,15,0,1,0,0,0,27,0
22,3,1,0,0,0,0,26,0
7,12,0,0,0,0,0,19,0
26,20,0,0,0,1,1,48,1
18,1,1,0,0,1,0,21,0
20,6,0,0,0,0,0,26,0
7,0,0,0,0,0,0,7,0
9,3,0,0,0,0,0,12,0
40,27,0,0,0,0,0,67,0
28,12,0,0,0,0,1,41,0
11,2,0,0,0,0,2,15,0
10,5,0,0,0,0,1,16,1
2,3,0,0,0,0,0,5,0
23,5,1,1,0,0,0,30,0
11,0,0,0,0,0,0,11,0
7,9,0,0,0,0,0,16,0
2,0,0,0,0,0,1,3,0
4,2,0,0,0,0,0,6,0
21,5,1,0,0,0,2,29,0
49,21,0,0,0,0,1,71,0
8,23,0,0,0,0,2,33,0
18,5,0,0,0,0,0,23,0
22,16,0,1,0,0,1,40,0
10,0,0,0,0,0,0,10,0
7,0,0,0,0,0,7,14,0
5,19,0,0,0,0,1,25,0
11,19,1,0,0,0,0,31,0
8,15,0,0,0,0,0,23,0
13,9,0,0,1,1,5,29,0
12,26,0,0,0,0,4,42,0
14,17,0,0,0,0,0,31,0
13,67,0,0,0,1,0,81,0
5,7,0,0,0,0,6,18,0
4,1,0,0,0,0,3,8,0
4,1,0,2,0,0,2,9,1
6,1,0,0,0,0,1,8,0
0,2,0,0,0,0,2,4,0
7,33,0,1,0,0,0,41,0
26,50,0,1,0,1,0,78,0
11,5,0,0,0,0,0,16,0
7,15,0,0,0,1,0,23,0
13,15,0,0,0,0,0,28,0
0,21,1,0,0,0,0,22,0
0,5,0,0,0,0,0,5,0
10,11,0,0,0,0,3,24,0
3,4,0,0,0,0,0,7,0
11,17,0,1,0,0,0,29,0
4,4,0,0,0,0,0,8,0
8,7,0,0,0,0,0,15,0
2,8,0,0,0,0,0,10,0
10,5,0,0,0,0,0,15,0
4,10,0,0,0,0,1,15,0
5,0,0,0,0,0,0,5,0
13,5,0,0,0,0,0,18,0
9,2,0,0,0,0,1,12,1
16,8,0,0,0,0,1,25,0
3,0,0,0,0,0,0,3,0
9,3,0,0,0,0,0,12,0
6,8,0,3,0,0,6,23,0
2,18,0,0,0,0,0,20,0
5,24,1,0,0,1,0,31,0
11,0,0,0,0,0,0,11,0
3,0,0,0,0,0,0,3,0
5,2,0,0,0,0,0,7,0
10,6,0,0,0,0,0,16,0
4,7,0,0,0,0,0,11,0
4,29,0,0,0,0,0,33,0
2,0,0,0,0,0,1,3,0
10,3,0,0,0,0,0,13,0
2,7,0,0,0,0,1,10,0
3,10,0,0,0,0,0,13,0
8,0,0,0,0,0,0,8,0
11,7,0,0,0,0,1,19,0
18,20,0,0,0,0,0,38,0
18,9,0,0,0,0,5,32,0
18,0,0,1,0,0,0,19,0
28,45,0,0,0,0,1,74,0
13,6,0,0,0,0,0,19,0
24,6,0,2,0,0,2,34,0
0,2,0,0,0,0,0,2,0
0,2,0,0,0,0,0,2,0
45,54,0,0,0,0,2,101,0
0,1,0,0,0,0,0,1,0
2,3,0,0,0,0,0,5,0
8,0,0,0,0,0,3,11,0
17,1,0,1,0,0,2,21,0
212,139,1,6,0,4,13,375,0
96,120,2,3,0,1,8,230,0
9,0,0,1,0,0,0,10,1
15,32,1,0,0,1,7,56,0
44,3,0,5,0,0,4,56,0
6,1,0,0,0,0,1,8,1
14,0,0,0,0,0,0,14,0
9,0,0,0,0,0,1,10,0
18,0,0,0,0,1,2,21,0
7,11,0,0,0,1,0,19,0
138,63,0,15,0,2,5,223,0
59,3,0,4,0,0,2,68,0
43,77,2,1,0,1,13,137,1
9,8,0,0,0,0,0,17,0
115,7,0,8,0,1,0,131,0
88,8,0,4,0,1,0,101,0
11,9,0,0,0,1,0,21,0
84,6,1,6,0,4,3,104,0
15,0,0,0,0,1,1,17,1
8,2,0,0,0,0,0,10,0
35,4,0,0,0,0,1,40,0
128,11,0,8,0,1,10,158,0
5,2,0,0,0,0,2,9,0
0,0,0,1,0,0,0,1,0
2,2,0,0,0,0,1,5,0
288,72,2,24,0,5,9,400,0
24,0,0,5,0,0,0,29,0
65,7,0,6,0,0,2,80,0
1,0,0,1,0,0,0,2,0
28,9,0,1,0,2,1,41,2
44,9,0,1,0,0,6,60,0
5,0,0,0,0,0,0,5,0
32,1,0,4,0,3,0,40,0
3,0,0,0,0,0,0,3,0
15,18,1,1,0,0,0,35,1
86,8,0,2,0,1,4,101,1
0,4,0,0,0,0,0,4,0
6,0,0,0,0,0,0,6,0
4,7,0,0,0,0,0,11,0
1,0,0,0,0,0,0,1,0
29,72,0,1,0,0,0,102,0
1,1,0,0,0,0,0,2,0
0,0,0,1,0,0,0,1,0
4,0,0,0,0,0,1,5,0
0,1,0,0,0,0,0,1,0
0,19,0,0,0,1,4,24,0
3,0,0,0,0,0,0,3,0
10,4,0,0,0,0,0,14,0
9,0,0,0,0,0,0,9,0
17,3,0,0,0,0,0,20,0
4,27,0,0,0,4,0,35,0
8,0,1,0,0,0,0,9,0
3,0,0,0,0,0,0,3,0
10,12,0,0,0,0,2,24,0
170,218,2,1,0,3,20,414,0
5,0,0,0,0,0,1,6,0
0,9,0,0,0,0,0,9,0
9,0,0,0,0,0,0,9,0
11,46,0,0,0,0,1,58,0
15,4,0,0,0,0,0,19,0
6,0,0,0,0,0,0,6,0
9,10,0,0,0,0,2,21,0
3,0,0,0,0,0,0,3,0
12,0,0,0,0,0,0,12,0
6,0,0,0,2,0,0,8,0
4,0,1,0,0,0,0,5,0
5,0,0,0,0,0,0,5,0
6,0,0,0,0,0,0,6,0
6,0,0,0,0,0,0,6,0
6,0,0,0,0,0,0,6,0
18,2,0,0,0,0,0,20,0
27,30,0,0,0,0,3,60,0
48,137,1,0,0,0,5,191,0
41,3,0,0,0,0,4,48,0
28,264,0,0,0,1,18,311,0
65,2,0,0,0,0,2,69,0
419,19,0,44,0,4,10,496,0
56,2,0,9,0,0,1,68,0
120,4,0,10,0,0,0,134,0
516,15,0,60,1,4,15,611,0
270,8,1,23,0,5,4,311,0
79,2,0,8,0,2,0,91,0
79,2,0,6,0,2,7,96,0
119,1,1,2,0,0,3,126,0
722,14,1,31,0,3,19,790,0
58,1,0,13,0,0,0,72,0
0,0,0,0,0,0,1,1,0
2,0,0,0,0,0,0,2,0
207,3,0,9,1,1,1,222,0
131,6,0,12,0,9,0,158,0
224,4,0,6,0,6,4,244,0
13,0,0,0,0,0,0,13,0
3,0,0,0,0,0,1,4,1
0,0,0,0,0,3,0,3,0
2,0,0,1,0,0,0,3,0
16,3,0,0,0,0,0,19,0
41,0,0,0,0,0,1,42,0
67,0,0,0,0,0,6,73,0
73,29,0,0,0,4,8,114,0
23,4,0,0,0,0,0,27,0
7,0,0,0,0,0,0,7,0
52,19,0,0,0,6,13,90,0
46,2,0,0,0,0,0,48,0
25,0,0,0,0,10,4,39,0
9,1,0,0,0,0,0,10,0
3,0,0,0,0,0,0,3,0
14,19,0,0,0,0,8,41,0
49,29,0,0,0,0,2,80,0
55,8,0,0,0,6,7,76,0
67,10,0,0,0,7,0,84,0
66,14,0,0,0,0,6,86,0
60,0,0,5,0,4,2,71,0
88,8,1,0,0,9,1,107,1
61,9,1,0,0,5,6,82,0
62,12,2,1,0,0,0,77,0
69,15,1,0,0,0,5,90,0
60,3,0,4,0,3,0,70,0
128,81,2,8,0,13,8,240,0
22,1,0,4,0,0,0,27,0
50,1,0,0,0,1,3,55,1
98,23,2,0,0,2,16,141,0
116,72,0,5,0,0,10,203,0
42,52,1,0,0,0,2,97,0
11,2,0,0,0,0,0,13,0
129,15,0,0,0,5,11,160,0
29,5,1,0,0,0,1,36,0
14,0,0,0,0,0,1,15,0
90,9,0,3,0,0,0,102,0
54,11,0,0,0,0,2,67,0
84,30,1,0,0,1,7,123,0
104,7,0,0,0,1,6,118,1
118,3,0,0,0,4,8,133,0
29,3,0,0,0,0,4,36,0
39,4,0,2,0,8,1,54,0
59,17,0,2,0,0,4,82,0
92,102,2,0,0,1,3,200,0
47,4,0,1,0,0,1,53,1
30,12,0,0,0,0,1,43,0
21,3,0,1,0,0,7,32,0
36,18,0,0,0,3,10,67,0
36,2,0,0,0,1,13,52,1
43,7,0,0,0,0,0,50,0
34,6,0,0,0,0,0,40,0
25,9,0,0,0,0,8,42,0
42,7,0,0,0,13,0,62,0
52,0,0,0,0,0,0,52,0
95,30,0,1,0,6,7,139,0
40,0,0,0,0,0,0,40,0
67,11,0,2,0,0,2,82,0
40,8,0,0,0,0,3,51,0
52,15,1,0,0,10,5,83,0
120,10,0,8,0,8,7,153,0
23,0,1,3,0,1,3,31,1
46,0,0,0,0,0,5,51,0
59,11,0,1,0,11,11,93,1
73,15,0,0,0,0,2,90,0
69,7,0,0,0,0,16,92,0
28,0,0,0,0,0,2,30,0
148,20,0,0,0,8,1,177,0
4,0,0,0,0,0,0,4,0
58,2,0,1,0,4,1,66,0
41,4,1,0,0,0,4,50,0
75,27,0,0,0,1,7,110,0
78,17,2,5,0,0,10,112,0
52,2,0,0,0,0,0,54,0
94,16,1,0,0,0,3,114,0
66,7,5,7,0,0,8,93,0
54,19,1,0,0,0,0,74,1
23,5,0,0,0,0,3,31,0
78,7,6,0,0,0,6,97,0
83,7,0,0,0,1,3,94,0
64,16,0,0,0,0,6,86,0
66,12,0,0,0,0,2,80,0
82,8,0,0,0,0,11,101,0
61,4,1,0,0,0,6,72,0
62,9,0,0,0,0,1,72,0
70,4,0,0,0,1,1,76,0
45,4,1,0,0,3,1,54,0
118,15,1,2,0,0,1,137,0
55,4,1,5,0,4,1,70,0
1,1,0,0,0,0,1,3,1
33,0,0,0,0,0,0,33,0
88,6,0,0,0,2,1,97,0
22,6,0,0,0,1,0,29,1
56,15,0,1,0,0,4,76,0
43,9,0,7,0,0,4,63,0
63,7,0,7,0,10,3,90,0
67,6,0,0,0,4,3,80,0
66,10,1,0,0,0,3,80,1
80,15,0,0,0,5,3,103,0
64,3,0,0,0,0,0,67,0
27,3,0,3,0,6,1,40,0
2,0,0,0,0,0,0,2,0
58,0,0,0,0,3,0,61,0
44,0,0,0,0,0,1,45,0
36,0,0,0,0,0,0,36,0
52,4,0,0,0,8,2,66,0
35,6,0,0,0,0,0,41,0
57,3,0,0,0,0,0,60,0
59,6,1,0,0,0,5,71,0
56,0,0,0,0,0,0,56,0
75,0,3,0,0,0,5,83,0
87,4,0,0,0,0,0,91,0
86,5,0,1,0,2,4,98,0
21,0,0,0,1,0,0,22,0
49,2,0,0,0,0,0,51,0
77,2,0,0,0,0,0,79,0
80,2,0,0,0,0,3,85,0
40,4,0,1,0,1,6,52,0
90,9,0,0,0,4,11,114,0
47,5,0,0,0,0,4,56,0
85,6,0,3,0,0,0,94,0
50,4,0,0,0,7,1,62,1
1,0,0,0,0,0,0,1,0
38,3,1,0,0,0,0,42,0
50,10,0,1,0,0,0,61,0
25,0,0,0,0,9,6,40,0
30,2,0,0,0,3,0,35,0
42,4,0,0,0,6,4,56,0
11,0,0,0,0,0,0,11,0
42,1,0,0,0,0,1,44,0
73,4,0,0,0,0,0,77,0
66,3,0,0,0,0,0,69,0
76,5,1,2,0,0,1,85,0
70,10,0,0,0,0,12,92,0
53,6,0,0,0,1,1,61,0
63,9,0,0,0,0,1,73,0
53,5,0,0,0,3,1,62,1
61,1,0,2,0,0,16,80,0
65,3,0,0,0,0,0,68,0
50,0,0,0,0,0,0,50,0
34,0,0,0,0,0,0,34,0
71,5,3,0,0,3,3,85,0
57,4,0,1,0,0,0,62,0
42,3,0,0,0,0,0,45,0
64,2,0,2,0,0,3,71,0
46,4,0,0,0,2,0,52,0
46,4,0,1,0,0,0,51,1
57,8,0,3,0,0,1,69,1
13,5,0,0,0,19,0,37,0
72,3,0,0,0,2,2,79,0
92,8,0,0,0,1,4,105,0
53,0,0,0,0,0,0,53,0
32,6,0,3,0,0,3,44,0
66,0,1,0,0,1,0,68,0
63,1,0,0,0,0,0,64,0
39,7,1,15,0,0,4,66,0
48,1,0,0,0,1,3,53,0
57,40,1,1,0,2,9,110,0
95,17,0,0,0,4,15,131,0
99,20,0,0,0,0,10,129,0
70,3,0,11,0,0,1,85,0
71,22,0,0,0,5,4,102,0
59,14,0,2,0,0,4,79,0
43,18,1,0,0,15,2,79,0
93,7,0,0,0,8,6,114,0
136,9,0,0,0,0,23,168,0
62,18,3,2,0,3,9,97,0
70,33,0,1,0,8,3,115,0
80,16,0,15,0,6,2,119,0
88,18,1,2,0,5,1,115,0
98,2,0,0,0,15,6,121,0
86,11,0,0,0,8,11,116,0
70,24,0,0,0,0,6,100,0
42,0,0,0,0,7,0,49,0
62,20,0,4,0,13,11,110,0
32,7,0,4,0,1,4,48,0
44,2,0,1,0,0,1,48,0
63,23,0,10,0,0,13,109,0
55,10,1,0,0,3,2,71,0
35,4,3,2,0,0,3,47,0
69,11,0,0,0,3,9,92,0
118,8,1,6,0,16,8,157,0
114,18,2,0,0,5,9,148,0
77,77,2,1,0,7,17,181,0
74,62,0,3,0,0,15,154,0
61,35,0,10,0,7,2,115,0
21,18,1,0,0,6,9,55,0
10,27,1,0,0,0,12,50,0
19,25,0,0,0,0,10,54,0
16,6,0,0,0,22,4,48,0
53,67,0,1,0,0,7,128,0
54,66,0,0,0,15,3,138,0
34,27,0,0,0,0,11,72,0
17,8,0,0,0,0,0,25,0
12,12,0,0,0,5,0,29,0
38,58,1,2,0,6,6,111,0
8,2,0,0,0,0,1,11,0
19,25,0,19,0,5,10,78,0
40,34,2,2,0,4,1,83,1
6,19,0,0,0,5,1,31,0
11,35,0,0,0,4,0,50,0
23,14,0,0,0,8,10,55,0
8,12,0,0,0,0,8,28,0
10,12,0,0,0,0,0,22,0
49,47,0,0,0,8,8,112,0
49,34,0,0,0,0,5,88,0
26,11,0,2,0,0,3,42,0
8,22,0,0,0,0,3,33,0
5,28,0,0,0,1,4,38,0
25,32,0,2,0,0,0,59,0
16,1,7,0,0,0,2,26,0
72,49,1,4,0,6,19,151,1
59,51,2,0,0,5,5,122,0
87,35,3,0,0,0,5,130,0
47,19,0,14,1,31,2,114,0
10,25,5,0,0,0,0,40,0
18,15,0,0,0,4,0,37,0
14,18,0,1,0,0,3,36,0
22,15,0,0,0,0,0,37,0
44,48,0,0,0,1,10,103,0
40,31,0,0,0,0,19,90,0
65,30,0,0,0,2,7,104,0
46,19,0,0,0,0,5,70,0
66,18,0,0,0,14,8,106,0
99,46,0,0,0,6,6,157,0
30,66,0,0,0,0,6,102,0
62,37,3,0,0,0,3,105,0
83,32,6,0,0,0,15,136,0
75,14,1,1,0,8,6,105,1
81,3,0,1,2,15,1,103,1
65,7,0,0,0,0,4,76,0
31,29,0,17,0,6,10,93,0
72,27,0,0,0,4,0,103,0
80,18,0,0,0,0,4,102,0
97,14,0,0,0,0,12,123,0
75,18,0,0,0,12,8,113,0
72,16,0,0,0,0,16,104,0
107,0,0,0,0,6,5,118,0
104,10,0,0,0,5,3,122,0
91,1,1,1,0,9,14,117,0
94,28,0,0,0,10,4,136,0
67,9,4,11,0,1,0,92,0
50,0,0,2,0,0,0,52,0
50,4,0,2,0,0,4,60,0
59,22,0,4,0,0,8,93,0
12,9,0,0,0,0,1,22,0
70,24,0,4,0,5,11,114,0
31,3,0,0,0,4,0,38,0
128,22,0,14,0,0,11,175,0
39,3,2,0,0,4,2,50,0
47,14,0,0,0,3,4,68,0
65,5,0,0,0,2,1,73,1
66,14,0,7,0,8,0,95,0
70,6,0,0,0,2,1,79,0
62,15,0,0,0,0,3,80,0
56,14,0,0,0,5,2,77,0
37,7,0,0,0,6,3,53,0
28,5,1,0,0,0,0,34,0
23,10,0,0,0,0,0,33,0
20,0,0,5,0,0,0,25,0
44,0,0,1,0,1,0,46,0
48,1,0,0,0,0,1,50,1
51,5,0,0,0,5,2,63,0
60,7,0,0,0,9,1,77,0
61,8,0,0,0,2,1,72,0
46,8,2,1,0,0,1,58,0
50,6,0,0,0,2,3,61,0
34,3,0,0,0,5,0,42,0
37,5,0,6,0,0,3,51,0
61,1,0,0,0,1,2,65,0
41,4,0,4,0,0,3,52,0
63,1,0,0,0,0,1,65,2
43,0,0,0,0,5,0,48,0
43,0,0,1,0,0,0,44,0
31,0,0,0,0,0,5,36,0
39,0,0,0,0,0,3,42,0
41,0,1,0,0,0,0,42,0
58,3,0,0,0,4,5,70,0
68,0,1,0,0,0,0,69,0
67,6,0,0,0,2,5,80,0
66,14,0,4,0,0,0,84,0
82,0,0,0,0,0,3,85,0
81,13,0,3,0,8,7,112,0
71,0,0,2,0,0,2,75,0
75,8,0,0,0,0,6,89,0
40,11,0,0,0,2,1,54,1
41,20,0,0,0,0,3,64,0
34,4,3,0,0,1,2,44,1
71,23,0,0,0,10,2,106,0
78,18,1,5,0,4,7,113,0
61,28,0,3,0,7,13,112,0
51,7,0,3,0,4,0,65,0
25,13,0,9,0,4,1,52,0
43,11,1,0,0,7,2,64,0
20,26,0,0,0,4,3,53,0
30,10,1,0,0,0,6,47,0
18,24,0,0,0,7,2,51,0
55,28,0,0,0,0,5,88,0
54,12,1,0,0,0,1,68,1
30,13,0,0,0,0,4,47,0
45,13,1,0,0,0,5,64,0
51,1,0,0,0,0,0,52,0
29,15,0,5,0,0,0,49,0
14,20,0,0,0,0,0,34,0
32,17,0,0,0,0,0,49,0
72,22,0,0,1,12,7,114,0
38,2,0,0,0,19,0,59,0
57,3,0,0,0,1,0,61,0
41,5,0,4,0,0,0,50,0
35,2,0,0,0,0,0,37,0
44,3,0,0,0,0,1,48,0
28,4,0,0,0,0,0,32,0
20,2,0,0,0,0,0,22,0
60,27,0,3,0,11,8,109,0
71,25,0,7,0,1,2,106,0
59,10,0,3,0,0,0,72,0
37,2,0,8,0,0,0,47,0
52,15,0,0,0,0,8,75,0
102,13,0,0,0,0,13,128,0
43,10,0,1,0,3,0,57,0
45,3,0,0,0,10,1,59,0
23,11,0,9,0,0,0,43,0
53,16,0,0,0,0,0,69,0
60,4,0,0,0,0,0,64,0
56,4,0,1,0,0,0,61,0
21,3,0,2,0,1,3,30,0
50,4,0,0,0,0,0,54,0
42,6,0,0,0,0,0,48,0
32,10,0,0,0,1,1,44,0
56,10,0,0,0,0,5,71,0
49,7,0,0,0,7,1,64,0
20,9,0,0,0,0,0,29,0
33,0,0,0,0,3,0,36,0
44,7,0,0,0,0,7,58,0
23,3,0,0,0,0,0,26,0
36,0,0,0,0,0,0,36,0
78,4,0,0,0,11,1,94,0
61,2,0,0,0,0,3,66,0
33,4,0,0,0,0,0,37,0
29,0,0,0,0,0,0,29,0
35,17,0,0,0,0,0,52,0
47,2,0,0,0,1,0,50,0
75,2,0,0,0,0,0,77,0
54,7,0,5,0,5,3,74,0
77,12,1,0,0,0,2,92,0
62,12,0,0,0,0,0,74,0
63,14,0,0,0,0,1,78,0
73,7,0,0,0,6,4,90,0
62,8,0,0,0,0,1,71,1
24,0,0,6,0,0,0,30,0
29,23,0,9,0,4,0,65,0
33,2,0,2,0,0,1,38,0
77,31,0,2,0,0,10,120,0
33,12,0,0,0,1,2,48,0
66,5,0,1,0,0,3,75,1
1,1,0,0,0,1,0,3,1
7,0,0,0,0,0,1,8,0
10,7,0,0,0,0,2,19,0
58,9,1,0,0,5,4,77,0
59,14,0,0,0,3,0,76,0
77,15,0,0,0,3,1,96,1
42,5,0,2,1,0,1,51,0
43,8,0,0,0,0,4,55,0
49,10,0,0,0,0,4,63,0
47,10,1,0,0,0,2,60,0
38,23,0,2,0,0,2,65,0
57,15,0,2,0,0,2,76,0
57,14,0,0,0,0,4,75,0
75,8,0,0,0,0,0,83,0
35,11,0,5,0,0,0,51,0
16,2,0,0,0,0,0,18,0
30,4,0,0,0,0,5,39,0
34,1,0,3,0,0,6,44,0
26,0,2,0,0,0,0,28,0
34,17,0,0,0,1,8,60,0
37,4,0,5,6,0,1,53,0
44,10,1,6,0,11,1,73,1
48,3,0,0,0,0,0,51,0
26,11,4,1,0,1,2,45,0
65,18,0,2,0,1,3,89,0
89,9,0,0,0,0,12,110,0
72,16,1,0,0,0,0,89,0
128,4,1,7,0,6,11,157,0
58,18,0,0,0,3,0,79,0
57,13,3,0,0,5,7,85,0
70,6,0,11,0,0,7,94,0
0,2,0,0,0,0,0,2,0
4,4,0,0,0,0,0,8,0
106,67,0,7,0,14,4,198,0
35,25,0,0,0,4,0,64,0
87,57,0,5,0,11,7,167,0
79,71,0,5,0,17,8,180,0
34,30,1,4,0,0,3,72,0
107,67,0,0,0,9,14,197,0
73,56,2,11,0,3,17,162,0
97,31,0,0,0,4,8,140,0
58,68,0,0,0,6,18,150,0
58,31,0,0,0,3,3,95,0
44,26,0,1,0,0,2,73,0
194,176,0,0,0,21,24,415,0
6,2,0,0,0,0,0,8,0
17,1,0,0,0,0,1,19,0
0,0,0,0,0,0,4,4,0
58,21,0,0,0,1,0,80,0
90,12,4,0,0,1,5,112,0
78,7,1,0,0,0,10,96,0
45,11,2,0,0,1,11,70,0
45,10,0,1,0,0,7,63,0
53,6,1,0,0,0,1,61,1
39,13,0,1,0,1,2,56,0
84,6,0,8,0,0,4,102,0
53,6,2,0,0,0,5,66,0
8,0,0,0,0,0,0,8,0
6,6,0,0,0,0,0,12,0
29,5,0,0,0,0,0,34,0
41,7,0,0,0,0,1,49,0
39,23,0,1,0,0,15,78,0
33,8,0,0,0,0,0,41,0
21,0,0,0,0,0,4,25,0
31,7,0,0,0,0,2,40,0
33,3,0,0,0,0,0,36,0
56,12,0,0,0,0,1,69,1
10,1,0,0,0,0,0,11,0
50,7,1,0,0,0,3,61,0
49,4,0,1,0,4,2,60,0
73,23,1,0,0,1,5,103,0
54,15,0,0,0,1,11,81,0
50,3,0,0,0,0,3,56,0
40,0,0,0,0,0,1,41,1
43,3,0,0,0,0,0,46,0
48,8,0,0,0,0,1,57,1
21,1,0,0,0,0,0,22,1
41,7,0,0,0,0,8,56,0
49,0,0,10,0,0,0,59,0
20,0,1,0,0,0,4,25,1
35,3,0,0,0,0,0,38,0
33,0,0,0,0,0,0,33,0
17,2,0,0,0,0,0,19,0
17,0,0,0,0,0,0,17,0
18,0,0,0,0,0,0,18,0
17,5,0,0,0,0,8,30,0
17,1,0,0,0,0,0,18,0
20,6,1,0,0,0,1,28,0
21,5,1,2,0,0,5,34,0
12,3,1,0,0,0,0,16,0
19,0,0,0,0,0,0,19,0
31,3,0,0,0,0,0,34,0
0,1,0,0,0,0,3,4,1
19,1,0,0,0,0,0,20,0
26,1,0,1,0,0,0,28,0
15,7,0,0,0,0,0,22,0
33,0,0,0,0,0,0,33,0
4,6,0,0,0,1,0,11,0
15,0,0,0,0,1,0,16,1
42,0,0,0,0,0,8,50,0
49,0,0,0,0,0,5,54,0
35,0,0,0,0,0,3,38,0
31,0,0,0,0,0,0,31,0
42,8,0,0,0,1,3,54,0
29,6,0,0,0,1,1,37,0
30,10,0,0,0,0,2,42,0
28,1,0,0,0,0,0,29,0
53,6,0,0,0,2,0,61,0
39,0,0,0,0,2,0,41,0
28,7,0,0,0,0,6,41,0
52,7,0,4,0,0,2,65,0
37,1,0,0,0,0,1,39,1
47,0,0,0,0,3,0,50,0
13,9,0,0,0,1,0,23,1
38,1,0,0,0,0,0,39,1
41,0,0,0,0,0,0,41,0
46,8,0,0,0,0,2,56,0
41,22,0,0,0,0,4,67,0
55,6,0,1,0,0,0,62,1
45,1,0,0,0,0,1,47,1
40,3,0,0,0,0,0,43,0
41,3,0,1,0,0,0,45,0
48,7,0,0,0,0,10,65,0
40,1,0,0,0,0,0,41,0
87,20,0,0,0,0,3,110,0
86,15,0,0,0,0,2,103,0
36,14,4,0,0,0,0,54,0
7,19,0,0,0,0,0,26,0
73,13,0,0,0,9,6,101,0
53,13,2,0,0,3,2,73,0
46,1,0,9,0,0,1,57,0
6,0,0,0,0,0,2,8,0
80,37,0,1,0,0,1,119,0
24,0,0,0,0,0,0,24,0
3,0,0,0,0,0,0,3,0
7,16,0,0,0,0,0,23,0
43,9,0,0,0,0,3,55,0
52,2,0,0,0,0,7,61,0
12,8,0,0,0,0,2,22,0
50,15,0,0,0,0,0,65,0
33,3,0,1,0,0,0,37,0
6,0,0,0,0,0,0,6,0
28,5,0,0,0,1,0,34,0
36,3,0,0,0,1,0,40,0
11,2,0,0,0,0,0,13,0
20,13,0,0,0,0,0,33,0
23,1,0,0,0,0,0,24,0
39,7,0,0,0,0,0,46,0
82,8,5,1,0,0,14,110,0
27,4,0,0,0,0,2,33,0
22,2,0,0,0,0,0,24,0
42,5,0,0,0,0,5,52,0
13,13,0,3,0,0,1,30,0
15,3,0,0,0,0,4,22,0
16,1,0,0,0,0,0,17,0
4,0,0,0,0,0,0,4,0
24,2,0,0,0,0,0,26,0
40,55,1,0,0,0,4,100,0
88,87,1,0,0,0,7,183,0
9,0,0,0,0,0,1,10,1
45,1,2,0,0,0,3,51,0
153,47,0,7,0,1,10,218,0
31,1,0,0,0,0,1,33,0
35,202,6,4,0,0,15,262,0
7,0,0,0,0,0,0,7,0
11,0,0,0,0,0,0,11,0
16,33,1,1,0,0,0,51,0
11,4,0,0,0,0,0,15,0
35,4,0,0,0,0,1,40,0
1,0,0,0,0,0,1,2,1
29,1,0,0,0,0,2,32,0
7,2,0,0,0,1,0,10,0
9,1,1,0,0,0,0,11,0
81,211,1,1,1,3,20,318,1
52,15,0,0,0,0,2,69,0
68,398,0,0,6,3,16,491,0
1,7,0,0,0,0,2,10,1
19,66,0,0,0,0,0,85,0
1,1,0,0,0,0,0,2,1
27,0,0,0,0,0,0,27,0
26,0,0,0,0,0,0,26,0
41,1,0,0,0,0,0,42,0
5,0,0,0,0,0,0,5,0
15,0,0,0,0,2,0,17,0
44,0,0,0,0,1,0,45,0
12,0,0,0,0,0,0,12,0
36,0,1,0,0,3,0,40,0
17,0,0,0,0,0,0,17,0
0,1,0,0,0,0,0,1,0
7,1,0,0,0,0,0,8,0
4,0,0,0,0,0,0,4,0
15,0,0,0,0,0,0,15,0
1,0,0,0,0,0,1,2,0
23,0,0,0,0,0,0,23,0
9,0,0,0,0,0,0,9,0
82,13,0,3,0,1,5,104,0
102,15,0,0,0,0,2,119,0
63,1,0,2,0,1,4,71,0
17,0,0,1,0,0,3,21,0
105,8,2,1,0,2,2,120,0
9,1,0,0,0,0,0,10,1
25,5,0,1,0,0,0,31,0
37,8,0,0,0,1,2,48,0
11,0,0,0,0,0,0,11,0
31,7,0,0,0,0,0,38,0
77,5,0,5,0,0,0,87,0
23,8,0,0,0,0,0,31,0
14,1,0,0,0,0,0,15,0
34,3,0,0,0,0,3,40,0
27,4,0,0,0,0,2,33,0
13,0,0,0,0,0,0,13,0
18,1,0,0,0,0,0,19,0
23,7,0,0,0,0,3,33,0
14,0,0,0,0,0,0,14,0
8,0,0,0,0,0,1,9,0
9,0,0,0,0,0,0,9,0
21,2,0,0,0,0,0,23,0
21,2,2,0,0,0,0,25,0
17,0,0,0,0,0,1,18,0
4,0,0,0,0,0,1,5,0
10,0,0,0,0,0,0,10,0
3,0,0,0,0,0,0,3,0
5,0,0,0,0,0,0,5,0
1,1,0,0,0,0,0,2,0
4,0,0,0,0,0,0,4,0
20,0,0,0,0,0,0,20,0
15,1,0,0,0,0,2,18,0
4,0,0,1,0,0,0,5,0
18,1,0,2,0,0,0,21,0
145,6,0,13,0,2,1,167,1
27,3,0,0,0,0,0,30,0
16,1,0,0,0,0,0,17,0
35,0,0,4,0,0,0,39,0
10,0,0,0,0,0,0,10,0
6,0,0,0,0,0,0,6,0
9,0,0,0,0,0,0,9,0
3,0,0,1,0,0,0,4,1
4,0,0,0,0,0,0,4,0
9,0,0,0,0,0,0,9,0
12,0,0,0,0,0,0,12,0
3,0,0,0,0,0,0,3,0
12,0,0,0,0,1,0,13,0
28,0,0,0,0,0,0,28,0
17,0,0,0,0,0,0,17,0
29,5,0,0,0,0,1,35,0
36,0,0,0,0,0,0,36,0
10,1,0,0,0,0,0,11,0
14,0,0,0,0,0,0,14,0
5,0,0,0,0,0,0,5,0
2,0,0,2,0,0,0,4,0
6,0,0,0,0,0,0,6,0
4,0,0,0,0,0,0,4,0
4,2,0,0,0,0,0,6,0
8,0,0,0,0,0,0,8,0
4,0,0,0,0,0,0,4,0
4,0,0,0,0,0,0,4,0
5,0,0,0,0,0,0,5,0
5,2,0,0,0,0,0,7,0
6,0,0,0,0,0,0,6,0
8,1,0,0,0,0,0,9,0
5,0,0,0,0,0,0,5,0
9,0,0,0,0,0,0,9,0
26,6,0,1,0,2,0,35,0
25,1,0,1,0,0,2,29,0
19,0,0,0,0,0,0,19,0
17,1,0,0,0,0,2,20,0
15,0,0,0,0,0,0,15,0
24,0,0,0,0,0,1,25,1
49,0,0,1,0,0,0,50,0
30,0,0,0,0,0,0,30,0
6,0,0,0,0,0,0,6,0
10,0,0,1,0,0,1,12,0
6,0,0,1,0,0,0,7,0
4,0,0,0,0,0,1,5,1
6,1,0,0,0,0,0,7,0
14,0,0,2,0,0,0,16,0
12,0,0,0,0,0,0,12,0
21,0,0,0,0,0,0,21,0
7,0,0,1,0,0,1,9,0
32,1,0,0,0,0,0,33,0
18,0,0,0,0,0,0,18,0
9,0,0,0,0,0,0,9,0
10,0,0,0,0,0,1,11,0
22,0,0,2,0,0,0,24,0
25,1,0,0,0,0,0,26,1
19,0,0,1,0,0,0,20,0
37,0,0,0,0,0,1,38,1
0,2,0,0,0,0,0,2,0
61,1,0,0,0,0,1,63,0
44,0,0,3,0,0,0,47,0
38,1,0,1,0,0,5,45,0
28,0,0,0,0,0,3,31,0
15,5,0,0,0,0,0,20,0
10,0,0,0,0,0,0,10,0
4,0,0,0,0,0,0,4,0
52,3,0,3,0,0,0,58,0
18,0,0,0,0,0,0,18,0
37,1,0,0,0,0,1,39,0
40,0,0,2,0,0,4,46,0
16,0,0,1,0,0,0,17,0
32,0,0,1,0,0,1,34,1
21,0,0,0,0,0,0,21,0
15,0,0,0,0,0,0,15,0
4,0,0,0,0,0,0,4,0
2,20,0,0,0,0,0,22,0
7,31,0,0,0,0,2,40,0
19,62,0,3,0,3,4,91,0
10,65,2,0,0,1,3,81,0
6,60,0,0,0,0,4,70,0
3,45,0,0,0,0,2,50,0
6,63,0,0,0,0,0,69,0
1,25,0,0,0,0,3,29,0
0,21,0,0,0,0,0,21,0
2,21,0,1,0,0,0,24,0
9,26,0,0,0,0,4,39,0
2,13,0,1,0,0,0,16,0
5,50,0,2,0,0,2,59,0
12,11,0,3,0,0,3,29,0
1,51,1,0,0,0,3,56,1
6,10,0,0,0,0,2,18,0
42,213,1,0,0,3,5,264,0
8,70,1,0,0,0,10,89,0
2,37,0,0,0,0,0,39,0
14,44,0,0,0,0,0,58,0
8,36,0,0,0,0,1,45,0
2,20,0,0,0,0,0,22,0
5,62,0,0,0,0,2,69,0
11,51,0,0,0,0,4,66,0
22,13,0,0,0,0,0,35,0
74,74,1,0,0,0,0,149,0
4,5,0,0,0,0,0,9,0
9,26,0,0,0,0,0,35,0
14,4,0,0,0,0,0,18,0
14,5,0,0,0,0,1,20,1
19,8,0,0,0,0,2,29,0
7,10,0,0,0,0,0,17,0
7,17,0,0,0,0,1,25,0
4,0,0,0,0,0,0,4,0
4,34,0,0,0,0,0,38,0
3,13,0,0,0,0,0,16,0
1,12,0,0,0,0,0,13,0
4,11,0,0,0,0,1,16,0
12,44,0,0,0,0,2,58,0
4,4,0,0,0,0,0,8,0
22,5,0,0,0,0,2,29,0
2,12,0,0,0,2,0,16,0
32,108,2,3,0,1,7,153,0
3,4,0,0,0,0,0,7,0
0,0,0,1,0,0,0,1,0
7,28,0,0,0,0,1,36,0
4,75,0,0,0,0,0,79,0
0,13,0,0,0,0,2,15,0
3,7,0,0,0,0,0,10,0
9,7,0,0,0,0,0,16,0
0,37,0,0,0,0,0,37,0
7,0,0,0,0,0,0,7,0
0,4,0,0,0,0,0,4,0
0,9,0,0,0,0,0,9,0
6,25,0,0,0,0,0,31,0
7,14,0,0,0,0,0,21,0
6,0,0,0,0,0,0,6,0
29,43,0,2,0,0,1,75,0
19,57,0,0,0,0,0,76,0
15,10,0,0,0,0,6,31,0
11,25,0,0,0,0,2,38,0
3,16,0,0,0,0,0,19,0
7,8,0,0,0,0,1,16,0
0,4,0,0,0,0,0,4,0
9,1,0,0,0,0,0,10,0
3,57,0,0,0,0,0,60,0
8,15,0,0,0,2,0,25,0
1,26,0,0,0,0,0,27,1
2,2,0,0,0,0,0,4,0
8,15,0,1,0,0,1,25,1
11,32,1,0,0,0,0,44,0
17,12,0,0,0,0,0,29,0
5,30,0,1,0,0,0,36,1
0,5,0,0,0,0,0,5,0
8,34,0,1,0,0,0,43,1
2,33,0,0,0,0,0,35,0
11,48,0,0,0,0,2,61,0
12,43,0,0,0,0,3,58,0
0,1,0,0,0,0,0,1,0
2,70,2,0,0,0,3,77,0
0,57,0,1,0,0,0,58,0
1,59,0,0,0,0,1,61,0
3,30,0,0,0,2,0,35,0
2,62,0,0,0,0,4,68,0
0,7,0,0,0,0,0,7,0
0,53,0,0,0,0,5,58,0
0,9,0,0,0,0,0,9,0
0,29,0,0,0,0,0,29,0
0,16,0,0,0,0,1,17,1
1,6,0,0,0,0,0,7,0
6,16,0,1,0,0,0,23,0
0,14,0,0,0,0,1,15,0
3,10,0,0,0,0,0,13,0
0,43,0,0,0,0,0,43,0
0,39,0,0,0,0,6,45,0
4,36,0,0,0,0,3,43,0
1,63,0,0,0,0,0,64,0
3,61,0,0,0,0,0,64,0
1,33,0,0,0,0,3,37,0
5,52,0,0,0,0,2,59,0
5,38,0,0,0,1,1,45,0
8,53,3,0,0,0,5,69,0
11,46,0,0,0,0,4,61,0
8,57,0,0,0,0,0,65,0
3,52,1,0,0,0,0,56,0
1,26,0,0,0,0,1,28,0
6,45,0,0,0,0,2,53,0
4,35,0,0,0,0,0,39,0
6,26,0,0,0,0,0,32,0
4,49,0,0,0,0,0,53,0
3,23,0,0,0,1,0,27,0
1,0,0,0,0,0,0,1,1
1,34,0,0,0,0,0,35,0
6,45,0,0,0,0,0,51,0
5,90,0,0,0,6,4,105,0
3,40,0,0,0,0,0,43,0
3,131,0,0,0,0,5,139,0
0,13,0,0,0,1,0,14,0
0,74,0,0,0,5,0,79,0
0,41,0,0,0,0,0,41,0
6,58,0,0,0,1,1,66,1
0,27,0,0,0,0,2,29,0
0,15,0,0,0,0,1,16,1
5,26,0,0,0,0,0,31,0
9,63,0,1,0,0,0,73,0
4,37,0,0,0,0,3,44,0
4,57,0,0,0,0,3,64,0
1,52,0,0,0,0,8,61,0
11,62,0,0,0,4,4,81,0
3,70,0,0,0,1,0,74,0
5,40,0,0,0,1,3,49,0
3,31,0,0,0,0,6,40,0
0,37,0,0,0,0,0,37,0
8,36,0,0,0,0,0,44,0
0,22,0,0,0,0,0,22,0
5,55,0,0,0,0,4,64,0
3,46,1,0,0,3,0,53,0
3,45,0,0,0,0,2,50,0
0,9,0,0,0,0,7,16,0
4,38,0,0,0,0,2,44,0
12,75,0,0,0,0,6,93,0
19,43,0,0,0,0,0,62,0
9,79,0,0,0,0,5,93,0
12,57,0,0,0,0,2,71,0
3,70,0,0,0,0,1,74,0
8,53,0,0,0,0,4,65,0
0,34,2,0,0,0,0,36,0
0,4,0,5,0,2,0,11,0
0,11,0,0,0,0,0,11,0
1,21,0,1,0,0,0,23,0
4,64,1,0,0,0,0,69,0
11,41,1,0,0,0,3,56,0
6,16,0,0,0,0,0,22,0
1,17,0,0,0,0,0,18,0
1,62,0,0,0,0,1,64,1
3,58,0,0,0,0,3,64,0
0,34,0,0,0,0,0,34,0
7,31,0,0,0,3,5,46,0
1,40,1,0,0,3,1,46,1
5,49,0,0,0,0,1,55,0
0,60,0,0,0,0,4,64,0
1,39,1,0,0,0,0,41,0
3,41,0,1,0,0,0,45,0
0,4,0,0,0,0,0,4,0
4,37,0,0,0,0,0,41,0
3,24,0,0,0,0,0,27,0
8,35,0,0,0,0,0,43,0
0,40,0,0,0,0,0,40,0
13,73,0,0,0,0,5,91,0
0,92,0,0,0,0,10,102,0
6,71,1,0,0,0,0,78,1
0,68,0,0,0,0,0,68,0
2,63,0,0,0,1,1,67,0
0,66,0,0,0,0,5,71,0
5,125,0,1,0,0,1,132,0
0,115,0,0,0,0,7,122,0
0,22,0,0,0,0,0,22,0
0,29,0,0,0,0,0,29,0
0,4,0,0,0,0,0,4,0
0,5,0,0,0,0,0,5,0
0,8,0,0,0,0,0,8,0
8,35,0,0,0,0,0,43,0
2,23,0,0,0,0,2,27,0
8,138,0,0,0,3,16,165,0
1,100,0,0,0,0,2,103,0
10,19,0,0,0,0,1,30,0
4,53,0,1,0,0,2,60,0
0,52,1,1,0,4,2,60,0
4,20,0,0,0,0,0,24,0
5,41,0,0,0,1,6,53,0
1,64,0,0,0,0,1,66,1
0,22,0,0,0,0,2,24,0
0,13,0,0,0,0,0,13,0
4,62,0,0,0,0,0,66,0
8,49,0,1,0,1,1,60,0
1,53,1,0,0,0,0,55,0
6,47,0,4,0,0,2,59,0
7,24,0,0,0,0,16,47,0
6,34,0,0,0,0,4,44,0
2,61,0,0,0,0,1,64,1
1,7,0,0,0,0,0,8,0
2,15,0,0,0,0,0,17,0
0,13,0,0,0,0,0,13,0
2,30,2,0,0,0,2,36,0
3,40,0,0,0,0,0,43,0
17,30,0,0,0,0,5,52,0
8,67,0,0,0,0,1,76,1
11,54,1,0,0,0,3,69,0
10,41,2,1,0,0,8,62,0
7,38,0,0,0,0,8,53,0
0,46,0,0,0,0,6,52,0
3,55,0,0,0,0,2,60,0
6,33,0,0,0,0,0,39,0
5,24,0,0,0,0,0,29,0
18,62,0,0,0,4,7,91,0
0,5,0,0,0,0,0,5,0
0,8,0,0,0,0,0,8,0
3,21,1,0,0,0,4,29,0
0,6,0,3,0,0,0,9,0
8,49,0,0,0,0,1,58,1
3,28,0,0,0,5,0,36,0
4,18,0,0,0,4,2,28,0
13,20,0,0,0,1,4,38,1
2,35,0,0,0,4,1,42,0
7,21,0,0,0,0,17,45,0
1,26,0,0,0,1,2,30,0
2,32,0,0,0,0,5,39,0
0,18,0,0,0,0,0,18,0
13,19,0,0,0,0,2,34,0
4,35,0,0,0,0,2,41,0
3,46,0,0,0,0,1,50,0
7,23,1,0,0,0,1,32,0
4,40,0,0,0,0,0,44,0
7,66,0,0,0,0,2,75,0
6,52,0,0,0,0,1,59,0
3,37,0,1,0,0,0,41,0
2,39,0,0,0,0,6,47,0
0,37,0,0,0,0,8,45,0
1,41,1,0,0,0,0,43,0
6,40,0,0,0,0,5,51,0
1,12,0,0,0,0,4,17,1
0,3,0,0,0,0,0,3,0
2,26,0,0,0,0,0,28,0
4,25,0,0,0,7,3,39,0
4,26,0,0,0,0,0,30,0
0,17,0,0,0,0,3,20,0
3,27,0,0,0,0,4,34,0
17,37,0,0,0,0,0,54,0
5,14,0,0,0,0,2,21,0
0,19,0,0,0,0,0,19,0
12,19,0,0,0,0,1,32,1
8,8,0,0,0,0,0,16,0
17,12,0,0,0,0,0,29,0
7,15,0,0,0,0,1,23,0
6,1,0,0,0,0,3,10,0
12,18,0,0,0,0,0,30,0
14,13,0,0,0,0,1,28,0
8,5,0,0,0,0,0,13,0
6,4,0,0,0,1,0,11,0
2,10,0,0,0,0,2,14,0
4,3,0,0,0,0,0,7,0
8,8,0,0,0,0,0,16,0
21,10,2,0,0,0,3,36,0
11,7,0,0,0,0,4,22,0
1,0,0,0,0,0,0,1,0
11,3,0,0,0,0,0,14,0
16,27,0,0,0,0,0,43,0
31,16,0,0,0,0,5,52,0
30,24,0,0,0,0,4,58,0
11,18,0,0,0,0,4,33,0
17,26,1,0,0,0,3,47,0
6,21,1,0,0,0,0,28,1
5,18,0,0,0,0,1,24,0
3,0,0,0,0,0,0,3,0
1,14,0,0,0,0,0,15,0
1,15,0,0,0,2,4,22,0
5,7,0,0,0,0,0,12,0
6,26,0,0,0,0,0,32,0
4,27,0,0,0,0,0,31,0
0,13,0,0,0,0,0,13,0
2,10,0,0,0,0,1,13,0
0,13,0,0,0,0,0,13,0
2,7,0,0,0,0,0,9,0
1,0,0,1,0,0,0,2,0
25,3,0,0,0,1,0,29,0
5,5,0,0,0,0,0,10,0
14,5,0,0,0,0,0,19,0
1,4,0,0,0,0,0,5,0
3,13,0,0,0,0,0,16,0
6,12,0,0,0,0,0,18,0
0,9,0,0,0,0,0,9,0
6,27,0,0,0,0,4,37,0
4,8,0,0,0,0,5,17,0
8,19,0,0,0,0,0,27,0
8,5,0,0,0,6,0,19,0
12,10,0,0,0,0,0,22,0
4,17,1,0,0,0,3,25,0
9,4,1,0,0,0,0,14,0
1,7,0,1,0,0,0,9,0
4,13,2,0,0,0,2,21,0
2,4,0,0,0,0,0,6,0
22,7,0,0,0,0,2,31,0
9,7,0,0,0,0,0,16,0
4,19,0,0,0,0,1,24,0
19,2,0,0,0,7,0,28,0
0,13,0,0,0,0,5,18,0
3,9,0,0,0,0,0,12,0
6,11,0,0,0,0,0,17,0
0,3,0,0,0,0,0,3,0
0,2,0,0,0,0,1,3,0
9,21,0,0,0,3,4,37,0
8,19,0,0,0,0,6,33,0
11,36,0,0,0,0,1,48,0
7,28,0,0,0,0,0,35,0
8,10,1,0,0,0,3,22,0
5,43,0,0,0,0,3,51,0
10,30,0,0,0,0,0,40,0
3,32,0,0,0,0,12,47,0
5,30,0,0,0,0,6,41,0
3,18,0,0,0,0,4,25,0
11,9,0,0,0,0,0,20,0
7,22,0,0,0,6,2,37,0
29,8,0,0,0,4,2,43,0
16,27,1,0,0,0,2,46,0
21,15,0,0,0,0,4,40,0
17,7,0,0,0,0,0,24,0
26,9,1,0,0,0,0,36,0
5,0,0,0,0,0,0,5,0
30,6,0,0,0,0,1,37,0
12,13,0,0,0,0,0,25,0
34,9,0,0,0,0,1,44,1
32,6,0,0,0,0,2,40,0
47,11,0,1,0,0,3,62,0
21,18,2,0,0,0,2,43,0
5,29,0,0,0,4,0,38,0
30,43,0,0,0,0,4,77,0
28,35,0,0,0,0,0,63,0
36,15,0,0,0,0,0,51,0
25,6,0,0,0,0,0,31,0
23,17,0,0,0,0,0,40,0
40,4,0,2,0,0,4,50,0
1,1,0,0,0,0,0,2,0
26,23,0,0,0,0,0,49,0
25,19,0,0,0,0,2,46,0
21,46,0,0,0,0,8,75,0
42,30,0,0,0,0,3,75,0
34,27,0,0,0,0,1,62,0
22,17,0,5,0,0,1,45,1
29,28,0,0,0,0,3,60,0
33,13,0,0,0,0,2,48,0
26,24,0,0,0,0,0,50,0
39,16,0,0,0,0,3,58,0
36,9,0,1,0,4,0,50,0
26,19,0,0,0,0,3,48,0
42,18,0,0,0,4,0,64,0
42,0,0,0,0,0,0,42,0
43,17,0,1,0,0,0,61,0
28,9,0,0,0,0,0,37,0
21,7,0,0,0,0,1,29,0
42,18,0,0,0,3,3,66,0
32,19,1,0,0,0,2,54,0
24,16,0,0,0,0,7,47,0
18,0,0,0,0,0,3,21,0
3,0,3,0,0,0,0,6,0
25,3,0,0,0,0,0,28,0
63,12,0,0,0,0,7,82,0
15,11,0,0,0,0,2,28,0
9,1,0,1,0,0,0,11,0
31,1,0,2,0,0,6,40,1
39,11,0,0,0,0,0,50,0
21,10,0,0,0,1,0,32,0
5,0,0,0,0,0,0,5,0
9,0,0,0,0,0,0,9,0
12,9,0,0,0,0,1,22,1
20,10,0,0,0,0,1,31,0
48,17,1,0,0,0,5,71,1
71,14,1,0,0,0,2,88,0
45,29,0,0,0,0,4,78,0
28,11,0,1,0,0,0,40,0
17,3,0,0,0,1,0,21,0
47,4,0,0,0,0,2,53,0
36,3,0,0,0,1,0,40,0
42,0,0,0,0,0,0,42,0
81,89,5,0,0,2,6,183,0
32,2,0,0,0,0,0,34,0
58,1,0,1,0,0,1,61,0
47,0,0,2,0,0,0,49,0
19,0,0,1,0,0,0,20,0
86,0,0,0,0,0,0,86,0
32,0,0,0,0,0,0,32,0
34,1,0,0,0,0,1,36,0
36,0,0,2,0,0,2,40,0
20,1,0,0,0,0,1,22,0
27,2,0,0,0,0,1,30,1
24,0,0,1,0,0,1,26,0
31,0,0,0,0,0,0,31,0
35,0,0,0,0,0,0,35,0
16,6,0,1,0,1,2,26,0
61,1,0,1,0,0,0,63,0
42,8,0,0,0,0,0,50,0
39,0,0,1,0,0,0,40,0
13,0,0,0,0,0,0,13,0
15,0,0,0,0,0,0,15,0
24,1,0,1,0,0,1,27,0
22,1,0,0,0,0,0,23,0
25,0,0,1,0,0,0,26,0
34,1,0,3,0,0,1,39,0
25,1,0,0,0,0,1,27,0
5,0,0,0,0,0,0,5,0
20,2,0,0,0,0,1,23,1
10,0,0,0,0,0,0,10,0
28,0,0,0,0,0,0,28,0
19,0,0,1,0,0,0,20,1
29,0,0,0,0,1,0,30,0
19,0,0,0,0,0,1,20,0
24,0,0,0,0,0,0,24,0
17,0,0,0,0,0,0,17,0
12,0,0,0,0,0,0,12,0
12,0,0,1,0,0,0,13,0
22,1,0,2,0,0,3,28,0
17,0,0,0,0,0,0,17,0
22,2,0,0,0,0,0,24,0
7,0,0,1,0,0,0,8,0
3,0,0,0,0,0,0,3,0
18,0,0,0,0,0,1,19,0
47,0,0,3,0,0,0,50,0
15,0,0,0,0,1,0,16,0
7,0,0,0,0,0,0,7,0
4,1,0,0,0,0,0,5,0
15,0,0,0,0,0,0,15,0
17,0,0,1,0,0,0,18,0
13,0,0,1,0,0,0,14,0
17,0,0,0,0,0,0,17,0
14,0,0,0,0,0,0,14,0
23,0,0,1,0,0,0,24,0
30,1,0,0,0,0,0,31,1
8,0,0,0,0,0,0,8,0
20,0,0,0,0,0,0,20,0
24,0,0,0,0,0,2,26,0
29,0,0,0,0,0,0,29,0
44,0,0,0,0,0,1,45,1
25,1,0,0,0,1,1,28,0
21,1,0,0,0,0,0,22,0
10,0,0,0,0,0,0,10,0
17,0,0,0,0,0,0,17,0
39,0,0,0,0,0,0,39,0
20,0,0,0,0,0,0,20,0
16,0,0,0,0,0,0,16,0
10,0,0,0,0,0,0,10,0
16,0,0,0,0,0,0,16,0
12,1,0,0,0,0,0,13,0
45,1,0,1,0,0,0,47,1
26,0,0,1,0,0,0,27,0
54,4,1,1,0,1,3,64,0
10,0,0,0,0,0,0,10,0
18,1,0,0,0,0,0,19,1
5,0,0,0,0,0,0,5,0
12,3,0,0,0,0,0,15,0
317,17,0,22,0,2,10,368,0
39,0,0,0,0,0,0,39,0
20,1,0,1,0,0,0,22,0
9,0,0,1,0,0,0,10,0
15,0,0,1,0,0,0,16,0
15,0,0,1,0,0,1,17,0
29,0,0,0,0,0,1,30,0
33,4,0,1,0,0,0,38,0
30,0,0,0,0,0,1,31,0
23,0,0,0,0,0,0,23,0
26,0,0,0,0,0,1,27,1
29,0,0,0,0,0,1,30,0
17,0,0,0,0,0,0,17,0
32,0,0,0,0,0,2,34,0
28,0,0,0,0,0,0,28,0
14,0,0,1,0,0,0,15,0
20,0,0,0,0,0,0,20,0
18,2,0,1,0,0,1,22,0
11,0,0,0,0,0,0,11,0
18,3,0,0,0,0,0,21,0
22,0,0,0,0,0,0,22,0
38,0,0,1,0,0,0,39,0
19,0,0,0,0,0,0,19,0
13,1,0,0,0,0,0,14,1
24,0,0,0,0,0,2,26,0
13,0,0,0,0,0,0,13,0
20,0,0,0,0,1,0,21,0
12,0,0,0,0,0,0,12,0
11,1,0,0,0,0,0,12,1
2,0,0,0,0,0,0,2,0
5,0,0,0,0,0,0,5,0
16,0,0,0,0,0,0,16,0
16,0,0,0,0,0,0,16,0
17,0,0,0,0,0,0,17,0
34,0,0,1,0,0,1,36,0
15,2,0,0,0,0,0,17,0
11,0,0,0,0,0,0,11,0
21,4,0,1,0,0,0,26,0
10,0,0,0,0,0,0,10,0
28,1,0,0,0,0,0,29,1
22,0,0,0,0,0,0,22,0
31,3,0,0,0,0,2,36,0
14,0,0,0,0,0,0,14,0
10,1,0,2,0,0,0,13,0
7,0,0,0,0,0,0,7,0
7,0,0,0,0,0,0,7,0
10,0,0,0,0,0,0,10,0
8,0,0,0,0,0,0,8,0
0,0,0,0,0,0,1,1,0
8,0,0,0,0,0,0,8,0
26,0,2,1,0,0,2,31,1
67,3,0,4,0,0,1,75,1
7,0,0,0,0,0,0,7,0
16,5,0,0,0,0,0,21,0
26,0,0,0,0,0,0,26,0
12,0,0,0,0,1,0,13,0
40,0,0,0,0,0,0,40,0
22,0,0,0,0,0,1,23,0
9,0,0,0,0,0,0,9,0
20,0,0,0,0,2,0,22,0
35,0,0,0,0,0,0,35,0
26,1,0,1,0,0,0,28,0
9,0,0,0,0,0,0,9,0
36,2,0,0,0,1,4,43,0
36,0,0,0,0,0,0,36,0
13,0,0,2,0,0,1,16,0
49,1,0,0,0,0,0,50,1
38,0,0,0,0,0,0,38,0
12,0,0,0,0,0,0,12,0
28,0,0,2,0,0,5,35,0
35,0,0,0,0,0,0,35,0
31,2,0,0,0,0,0,33,0
22,0,0,0,0,0,1,23,0
19,7,0,0,0,0,0,26,0
17,1,0,0,0,0,0,18,0
29,0,0,0,0,0,0,29,0
16,0,0,0,0,0,0,16,0
26,0,0,1,0,0,0,27,0
31,1,0,0,0,0,0,32,0
35,0,0,0,0,0,0,35,0
43,5,0,0,0,1,0,49,0
44,3,0,0,0,0,1,48,0
61,0,0,0,1,0,1,63,0
30,0,0,0,0,0,0,30,0
47,4,0,0,0,0,0,51,0
48,1,0,0,0,0,2,51,0
88,2,0,0,0,2,3,95,0
101,6,0,0,0,1,3,111,1
52,11,0,0,0,0,3,66,0
136,15,0,3,0,0,6,160,0
80,0,0,2,0,1,0,83,1
57,0,0,4,0,1,1,63,1
58,0,0,1,0,2,0,61,1
64,1,0,0,0,0,0,65,0
20,0,0,1,0,0,1,22,0
12,1,0,0,0,0,0,13,0
0,0,0,0,0,1,0,1,0
9,2,0,0,0,0,0,11,0
55,4,0,1,0,2,4,66,0
36,3,0,1,0,1,2,43,0
46,1,0,0,0,1,1,49,1
46,0,0,0,0,0,1,47,0
36,0,0,0,0,0,0,36,0
50,7,0,0,0,1,2,60,0
55,0,0,0,0,0,1,56,0
41,0,0,2,0,1,0,44,0
27,5,0,0,0,0,0,32,0
33,3,0,1,0,0,0,37,0
15,0,1,2,0,0,1,19,0
55,1,0,0,0,0,0,56,0
63,4,0,0,0,0,5,72,0
26,6,0,0,0,0,0,32,0
38,12,0,0,0,0,2,52,0
70,4,0,0,0,0,0,74,0
34,0,0,0,0,0,0,34,0
31,2,0,2,0,0,2,37,0
26,6,0,0,0,2,0,34,0
6,0,0,0,0,0,0,6,0
22,0,0,0,0,0,0,22,0
28,12,0,1,0,0,0,41,0
30,5,0,0,0,0,0,35,0
57,8,0,0,0,0,0,65,0
23,2,0,3,0,0,4,32,0
16,3,0,0,0,0,0,19,0
83,5,0,2,0,1,7,98,0
35,0,0,0,0,0,1,36,1
24,1,0,4,0,0,0,29,0
24,12,2,0,0,2,8,48,0
20,2,0,0,0,0,0,22,0
40,3,0,0,0,1,1,45,1
90,3,0,3,0,4,11,111,0
11,1,0,0,0,0,0,12,0
0,0,0,0,0,1,0,1,1
45,6,0,0,0,1,0,52,0
45,2,1,2,0,0,0,50,0
95,1,0,0,0,3,11,110,0
30,0,0,0,0,0,2,32,0
32,1,0,0,0,0,1,34,0
70,2,0,0,0,0,0,72,0
82,2,0,0,0,0,0,84,0
25,0,0,0,0,0,0,25,0
18,2,0,0,0,0,0,20,0
40,3,1,0,0,0,3,47,0
48,0,0,0,0,0,0,48,0
40,0,0,1,0,0,3,44,0
43,0,0,2,0,0,1,46,1
67,0,0,0,0,0,0,67,0
35,2,0,0,0,0,0,37,0
9,3,0,0,0,0,1,13,1
93,1,0,1,0,0,6,101,1
90,3,1,0,0,0,2,96,0
33,1,0,0,0,0,0,34,1
42,7,1,0,0,0,0,50,0
49,0,0,0,0,0,0,49,0
34,0,3,0,0,0,0,37,0
39,6,0,0,0,0,2,47,0
37,8,0,0,0,0,0,45,0
14,0,0,0,0,0,0,14,0
4,0,0,0,0,0,0,4,0
34,0,0,1,0,0,2,37,0
40,6,0,0,0,0,0,46,0
75,8,1,0,0,0,8,92,0
54,0,0,1,0,0,1,56,0
11,0,0,3,0,0,0,14,0
0,32,0,0,0,0,0,32,0
10,42,5,0,0,0,0,57,0
1,20,0,0,0,0,4,25,0
2,14,0,0,0,0,2,18,0
10,66,0,0,0,0,5,81,0
9,43,0,0,0,3,6,61,0
11,56,0,1,1,0,11,80,0
14,52,1,0,1,0,8,76,1
0,1,0,0,0,0,0,1,0
14,39,2,0,0,1,3,59,0
4,34,0,5,0,0,0,43,0
7,37,0,0,0,0,2,46,0
20,61,0,0,0,0,0,81,0
5,43,0,0,0,0,1,49,0
15,48,0,0,0,0,0,63,0
13,33,0,0,0,0,7,53,0
20,45,0,0,0,0,6,71,0
39,39,0,0,0,0,6,84,0
48,11,0,0,0,3,2,64,0
20,39,1,0,0,0,1,61,0
13,24,1,0,0,0,0,38,0
12,18,1,0,0,0,1,32,1
21,7,0,6,0,0,0,34,0
18,19,0,0,0,0,0,37,0
21,32,0,4,0,0,0,57,0
14,64,1,1,0,3,2,85,0
8,29,0,6,0,0,4,47,0
16,41,0,1,0,1,10,69,0
3,18,0,0,0,0,0,21,0
8,38,0,0,0,0,3,49,0
6,51,0,0,0,0,4,61,0
10,8,0,0,0,0,4,22,0
15,23,0,0,0,0,5,43,0
18,17,0,0,0,0,2,37,0
32,49,0,0,0,0,2,83,0
21,58,0,0,0,0,0,79,0
6,16,0,0,0,0,0,22,0
7,35,0,0,0,0,5,47,0
12,45,0,0,0,0,0,57,0
9,62,5,0,0,0,2,78,0
7,45,0,3,0,0,2,57,0
17,24,0,0,0,0,1,42,0
1,39,0,1,0,0,2,43,0
16,64,0,0,0,0,0,80,0
8,24,0,0,0,0,0,32,0
0,65,0,0,0,0,2,67,0
3,53,0,0,0,0,2,58,0
14,50,0,0,0,0,0,64,0
39,9,0,0,0,0,0,48,0
72,24,0,0,0,1,15,112,0
38,3,0,0,0,0,0,41,0
34,279,0,0,0,6,6,325,0
49,13,1,0,0,0,1,64,0
34,9,1,6,0,1,0,51,0
29,7,0,0,0,0,0,36,0
58,8,0,0,0,1,2,69,0
35,16,0,0,0,0,9,60,0
41,14,0,0,0,0,3,58,0
5,2,0,0,0,0,0,7,0
31,0,0,0,0,0,0,31,0
45,12,0,0,0,0,0,57,0
23,0,0,0,0,0,0,23,0
25,1,0,0,0,0,0,26,0
0,1,0,0,0,0,1,2,0
28,13,0,0,0,0,5,46,0
16,3,0,0,0,0,0,19,0
0,91,0,0,0,0,9,100,0
59,379,0,0,0,8,48,494,0
37,15,0,1,0,2,0,55,0
1,0,0,0,0,0,0,1,0
31,21,0,0,0,2,0,54,0
22,7,0,0,0,0,0,29,0
29,2,0,0,0,0,1,32,1
20,0,0,0,0,0,0,20,0
10,11,0,1,0,1,1,24,0
25,3,0,0,0,0,4,32,0
22,6,0,0,0,0,0,28,0
32,3,1,0,0,1,1,38,1
27,1,0,0,0,0,0,28,0
29,4,0,0,0,0,2,35,0
12,0,0,0,0,2,0,14,0
33,3,0,0,0,0,2,38,0
23,6,0,0,0,0,2,31,0
36,3,0,0,0,0,1,40,0
38,0,0,0,0,0,0,38,0
23,7,0,0,0,0,1,31,0
29,6,0,0,0,0,2,37,0
34,2,0,0,0,0,12,48,0
7,15,0,0,0,0,1,23,0
67,28,0,0,0,1,10,106,0
4,0,0,0,0,0,0,4,0
41,2,0,0,0,0,6,49,0
63,3,1,0,0,0,3,70,0
32,0,0,0,0,0,0,32,0
20,5,0,0,0,0,1,26,0
69,8,0,0,0,0,0,77,0
42,8,0,0,0,1,0,51,0
7,0,0,0,0,5,0,12,0
68,9,0,0,0,0,1,78,0
16,0,0,0,0,0,0,16,0
35,12,0,0,0,0,0,47,0
20,11,0,0,0,0,0,31,0
35,6,0,0,0,0,0,41,0
24,0,0,0,0,0,1,25,0
16,0,0,0,0,0,0,16,0
7,2,0,0,0,0,0,9,0
36,0,0,0,0,0,0,36,0
35,4,0,0,0,0,2,41,0
4,11,0,0,0,0,3,18,0
26,30,2,0,0,0,0,58,0
12,17,0,2,0,0,0,31,0
22,35,0,0,0,2,5,64,0
18,7,1,1,0,0,0,27,0
48,26,2,0,0,0,3,79,0
5,0,0,0,0,0,0,5,0
8,4,2,0,0,0,0,14,0
1,0,0,0,0,0,0,1,0
6,1,0,0,0,0,1,8,0
31,3,0,0,0,0,2,36,0
29,7,0,0,0,0,2,38,0
14,13,0,0,0,0,0,27,0
10,2,0,0,0,0,0,12,0
1,0,0,0,0,0,0,1,0
2,0,0,0,0,0,0,2,0
3,9,0,0,0,0,0,12,0
33,4,0,0,0,1,0,38,0
57,6,0,0,0,0,3,66,0
75,10,5,0,0,0,9,99,0
26,0,5,0,0,0,1,32,0
36,6,0,0,0,0,0,42,0
41,6,0,0,0,5,0,52,0
11,0,4,0,0,0,0,15,0
10,0,0,0,0,0,0,10,0
42,17,0,0,0,1,4,64,0
39,10,0,0,0,0,0,49,0
64,10,1,4,0,2,11,92,0
28,8,0,0,0,0,1,37,0
43,6,1,0,0,0,1,51,0
39,0,0,0,0,0,2,41,0
66,4,0,0,0,1,0,71,0
82,28,0,0,0,0,4,114,0
78,12,0,0,0,0,2,92,0
6,0,0,0,0,0,1,7,0
15,10,0,0,0,0,1,26,0
16,3,0,0,0,0,0,19,0
13,1,0,0,0,0,0,14,0
15,0,0,0,0,0,0,15,0
2,0,0,0,0,0,0,2,0
16,7,0,0,0,1,2,26,0
21,1,0,0,0,0,1,23,0
64,0,0,0,0,1,8,73,0
23,2,0,0,0,1,0,26,0
1,0,0,0,0,0,1,2,0
43,0,0,0,0,0,0,43,0
469,11,1,69,0,26,13,589,0
45,0,0,0,0,0,0,45,0
49,3,0,1,0,0,0,53,0
12,0,0,1,0,0,0,13,0
26,0,0,4,0,0,0,30,0
131,0,0,0,0,1,0,132,1
70,0,0,1,0,1,0,72,0
51,2,0,0,0,0,0,53,0
52,0,0,0,0,0,0,52,0
23,0,0,1,0,0,4,28,0
6,0,0,0,0,0,0,6,0
27,5,0,0,0,0,2,34,0
3,0,0,0,0,0,0,3,0
6,0,0,1,0,0,0,7,0
4,0,0,0,0,0,0,4,0
12,0,0,0,0,0,0,12,0
7,0,0,1,0,0,2,10,1
21,0,0,0,0,0,0,21,0
0,0,0,1,0,0,0,1,0
12,0,0,0,0,1,0,13,1
10,0,0,0,0,0,0,10,0
0,0,0,2,0,0,0,2,0
196,0,0,11,0,0,1,208,0
12,0,0,0,0,0,0,12,0
47,0,0,0,0,0,0,47,0
72,7,0,10,0,0,5,94,0
35,0,0,0,0,0,0,35,0
13,4,0,0,0,0,0,17,0
11,0,0,0,0,0,0,11,0
11,0,0,0,0,0,0,11,0
34,7,0,36,0,2,4,83,0
35,6,1,0,0,0,3,45,0
85,0,0,0,0,0,0,85,0
58,0,0,4,0,2,0,64,0
2,0,0,0,0,0,0,2,0
119,3,0,4,0,0,1,127,0
36,0,0,7,0,0,0,43,0
65,0,0,0,0,0,0,65,0
140,6,0,5,0,0,5,156,0
75,0,0,10,0,0,0,85,0
137,11,0,24,1,1,0,174,0
25,3,0,5,0,0,0,33,0
115,14,1,27,0,2,1,160,0
50,3,0,12,0,0,2,67,0
75,6,0,23,0,0,2,106,0
110,10,0,30,0,0,4,154,0
215,24,0,23,0,2,12,276,0
80,0,0,0,0,5,5,90,0
97,4,0,3,0,0,4,108,0
63,0,0,3,0,0,5,71,0
15,0,0,5,0,0,0,20,0
16,0,0,0,0,0,0,16,0
21,0,0,1,0,0,0,22,0
35,0,0,2,0,0,0,37,0
47,0,0,2,0,0,0,49,0
28,0,0,0,0,0,0,28,0
82,0,0,5,0,0,1,88,1
35,4,0,0,0,0,0,39,0
53,1,0,4,0,0,0,58,1
64,1,0,25,0,0,7,97,0
16,0,0,19,0,0,0,35,0
8,0,0,0,0,0,0,8,0
345,1,0,24,0,0,6,376,0
33,0,1,7,0,0,0,41,0
21,0,0,1,0,0,0,22,0
28,0,0,1,0,2,0,31,0
96,4,0,16,0,0,6,122,0
27,0,0,0,0,0,0,27,0
146,3,0,6,0,0,3,158,0
5,0,0,0,0,0,0,5,0
21,0,0,0,0,0,0,21,0
3,0,0,0,0,0,0,3,0
82,7,0,7,0,0,1,97,0
70,0,0,0,0,0,0,70,0
29,0,0,0,0,0,0,29,0
79,3,1,24,0,5,3,115,0
332,13,0,60,0,22,8,435,0
27,5,0,3,0,0,2,37,0
12,1,0,2,0,0,0,15,0
19,4,0,3,0,0,1,27,0
31,3,0,1,0,0,3,38,0
18,0,0,0,0,0,0,18,0
14,0,0,3,0,0,0,17,0
12,0,0,0,0,0,0,12,0
235,2,1,18,0,1,8,265,0
12,0,0,10,0,0,0,22,0
90,0,0,5,0,1,0,96,0
86,2,0,12,0,15,0,115,0
8,0,0,0,0,0,0,8,0
113,4,0,8,0,0,3,128,0
17,0,0,0,0,0,1,18,0
1,0,0,0,0,0,0,1,0
29,0,0,2,0,0,0,31,0
12,0,0,2,0,0,4,18,0
49,7,0,144,0,4,10,214,0
90,14,0,158,0,6,7,275,0
8,5,0,15,0,0,4,32,0
40,1,0,0,0,0,1,42,0
58,1,0,7,0,1,0,67,0
2,0,0,3,0,0,0,5,0
19,0,0,8,0,0,0,27,0
7,2,0,0,0,0,0,9,0
101,3,1,129,0,1,2,237,0
13,0,0,0,0,0,0,13,0
6,1,0,0,0,0,0,7,0
70,7,0,70,0,1,2,150,0
32,8,0,16,0,0,2,58,0
2,0,0,0,0,0,0,2,0
237,20,0,45,0,0,2,304,0
25,0,0,0,0,0,0,25,0
62,3,0,9,0,1,0,75,0
50,1,1,6,0,2,0,60,0
67,0,0,27,0,0,2,96,0
30,1,0,9,0,0,1,41,0
62,1,0,40,0,0,6,109,0
5,0,0,0,0,0,0,5,0
129,10,0,23,0,0,3,165,0
17,0,0,1,0,0,0,18,0
22,0,1,1,0,0,3,27,1
9,0,0,0,0,0,0,9,0
4,0,0,0,0,0,0,4,0
9,0,0,0,0,0,0,9,0
115,0,0,6,0,0,1,122,0
27,1,0,1,0,0,0,29,0
33,0,0,0,0,0,3,36,0
76,0,0,2,0,0,0,78,0
3,0,0,0,0,0,0,3,0
391,10,0,29,0,2,10,442,0
38,0,0,1,0,0,1,40,0
35,0,0,0,0,0,0,35,0
1,0,0,4,0,0,0,5,0
54,0,0,3,0,0,0,57,0
21,0,0,2,0,0,0,23,0
25,0,0,0,0,0,0,25,0
10,0,0,0,0,0,0,10,0
8,0,0,0,0,0,0,8,0
9,0,0,5,0,0,0,14,0
13,0,0,0,0,0,0,13,0
96,3,0,0,0,0,2,101,0
5,0,0,0,0,0,0,5,0
19,0,0,0,0,0,0,19,0
63,0,0,7,0,0,0,70,0
11,0,0,5,0,0,2,18,0
108,7,0,22,0,0,4,141,0
11,1,0,6,0,0,0,18,0
3,0,0,0,0,0,0,3,0
5,1,0,0,0,0,0,6,0
42,4,0,33,0,0,3,82,0
125,3,0,98,0,0,0,226,0
53,1,0,76,0,0,6,136,0
98,8,0,56,0,0,3,165,0
25,0,0,22,0,0,0,47,0
35,0,0,19,0,0,3,57,0
27,0,0,8,0,0,0,35,0
29,0,0,18,0,0,0,47,0
103,5,0,27,0,1,7,143,0
14,2,0,30,0,0,0,46,0
94,5,0,77,0,1,6,183,0
38,0,0,35,0,0,2,75,0
13,0,0,0,0,0,0,13,0
78,3,0,22,0,0,4,107,0
31,0,0,4,0,0,0,35,0
20,0,0,0,0,0,0,20,0
38,0,0,3,0,0,0,41,0
25,0,0,0,0,0,0,25,0
70,0,0,2,0,0,0,72,0
85,0,0,4,2,0,1,92,0
40,0,0,0,0,0,0,40,0
28,0,0,0,0,0,0,28,0
10,0,0,0,0,0,0,10,0
24,0,0,0,0,0,0,24,0
23,0,0,0,0,0,0,23,0
6,0,0,0,0,0,0,6,0
37,0,0,4,0,0,4,45,0
3,0,0,0,0,0,0,3,0
15,4,0,4,0,0,0,23,0
1,0,0,0,0,0,1,2,0
111,10,0,43,0,0,1,165,0
3,0,0,0,0,0,0,3,0
0,0,0,1,0,0,0,1,1
26,0,0,24,0,0,4,54,0
14,0,0,0,0,0,0,14,0
50,0,0,1,0,0,0,51,0
97,0,0,5,0,0,2,104,0
70,0,0,1,0,0,4,75,1
115,3,0,9,0,0,4,131,0
28,0,0,0,0,0,0,28,0
7,0,0,0,0,0,0,7,0
0,0,0,0,0,0,6,6,0
10,0,0,0,0,0,0,10,0
44,1,0,86,0,0,4,135,1
13,0,0,4,0,0,0,17,0
16,0,0,46,0,0,1,63,0
22,0,0,48,0,3,0,73,0
0,2,1,28,0,1,4,36,0
64,6,0,2,0,0,3,75,0
245,18,1,77,0,4,13,358,0
91,9,0,61,0,0,5,166,0
44,1,0,18,0,1,2,66,0
39,5,0,19,0,0,7,70,0
8,0,0,6,0,0,1,15,0
179,16,1,30,0,2,1,229,0
43,5,2,14,0,0,0,64,0
13,5,0,0,0,0,0,18,0
122,6,0,42,0,0,7,177,0
14,0,0,3,0,0,0,17,0
18,0,0,0,0,0,0,18,0
12,0,0,1,0,0,0,13,0
7,0,0,2,0,0,2,11,0
290,6,1,49,0,4,16,366,0
6,0,0,0,0,0,0,6,0
5,0,0,4,0,0,0,9,0
11,0,0,7,0,0,0,18,0
24,0,0,3,0,0,0,27,0
11,0,0,13,0,0,2,26,0
75,8,0,28,0,1,3,115,0
7,5,0,32,0,0,0,44,0
4,0,0,5,0,0,0,9,0
18,2,0,17,0,0,4,41,0
12,0,1,0,0,0,0,13,0
2,0,0,0,0,0,0,2,0
7,0,0,0,0,0,0,7,0
0,0,0,0,0,5,0,5,0
6,0,0,0,0,0,0,6,0
2,1,0,0,0,0,0,3,0
6,0,0,0,0,0,0,6,0
103,2,0,21,0,1,0,127,0
38,2,0,10,0,0,1,51,0
52,1,0,20,0,0,4,77,0
83,4,0,42,0,0,4,133,0
22,0,0,21,0,0,0,43,0
75,0,0,22,0,0,1,98,0
19,4,0,18,0,0,0,41,0
107,10,0,49,0,0,5,171,0
12,0,0,10,0,0,0,22,0
8,0,0,9,0,0,4,21,0
425,17,0,195,0,0,20,657,0
15,2,0,1,0,0,0,18,0
54,0,0,106,0,5,3,168,0
17,0,0,6,0,4,0,27,0
14,1,0,6,0,0,0,21,1
47,0,0,26,0,0,11,84,0
28,2,0,12,0,2,1,45,1
50,0,0,5,0,0,4,59,0
9,1,0,12,0,0,1,23,0
21,1,0,7,0,0,0,29,1
37,3,0,21,0,2,0,63,0
19,2,0,2,0,0,0,23,0
2,0,0,0,0,0,0,2,0
11,0,0,0,0,0,0,11,0
5,0,0,0,0,0,0,5,0
4,0,0,0,0,0,0,4,0
1,0,0,1,0,0,1,3,0
2,0,0,0,0,0,0,2,0
5,0,0,0,0,0,0,5,0
31,0,0,1,0,0,0,32,0
15,0,0,0,0,0,0,15,0
25,0,0,0,0,0,5,30,0
3,0,0,3,0,0,0,6,0
2,0,0,0,0,0,0,2,0
26,0,1,0,0,0,1,28,1
0,0,0,0,0,1,0,1,0
12,0,0,0,0,0,0,12,0
1,0,0,0,0,0,0,1,0
21,0,0,0,0,0,0,21,0
6,0,0,0,0,0,0,6,0
2,0,0,0,0,0,0,2,0
5,0,0,0,0,0,1,6,0
139,11,0,28,0,0,2,180,0
12,0,0,0,0,0,0,12,0
5,0,0,0,0,0,0,5,0
19,0,0,4,0,0,0,23,0
505,25,0,50,0,13,13,606,0
15,1,0,3,0,0,0,19,0
38,5,0,0,0,0,1,44,0
4,0,0,0,0,4,0,8,0
22,1,0,8,0,0,2,33,0
57,0,0,3,0,8,0,68,0
51,1,0,2,0,0,4,58,0
36,7,0,6,0,0,3,52,0
85,2,0,4,0,3,2,96,0
87,2,0,4,0,6,2,101,0
81,4,0,2,0,0,3,90,0
14,2,0,0,0,0,0,16,0
17,0,0,1,0,0,0,18,0
26,9,0,6,0,0,0,41,0
44,3,0,1,0,1,0,49,1
19,0,0,0,0,0,0,19,0
15,0,0,0,0,36,6,57,0
39,7,0,6,0,12,0,64,0
14,1,0,0,0,0,0,15,1
15,0,0,0,0,0,0,15,0
98,3,0,4,0,0,0,105,0
3,0,0,0,0,0,0,3,0
46,0,0,0,0,25,0,71,0
13,0,0,0,0,12,0,25,0
53,15,0,0,0,1,1,70,1
35,0,0,3,0,0,0,38,0
24,8,0,2,0,0,6,40,0
23,0,0,2,0,0,0,25,0
13,0,0,6,0,0,0,19,0
15,0,0,0,0,0,0,15,0
4,0,0,0,0,0,0,4,0
16,0,0,0,0,0,0,16,0
1,0,0,0,0,0,0,1,0
10,0,0,0,0,0,0,10,0
7,0,0,0,0,0,0,7,0
0,4,0,0,0,0,1,5,0
8,0,0,0,0,0,0,8,0
38,0,0,2,0,0,0,40,0
40,5,0,0,0,0,0,45,0
46,3,0,0,0,0,0,49,0
49,0,0,5,0,0,0,54,0
0,0,0,0,0,0,1,1,0
0,0,0,0,0,5,0,5,0
94,0,0,0,0,0,9,103,0
8,0,0,0,0,0,0,8,0
53,1,0,0,0,0,0,54,0
8,0,0,0,0,0,0,8,0
45,2,0,0,0,0,0,47,0
70,3,1,3,0,2,0,79,0
5,0,0,3,0,0,0,8,0
295,1,0,21,0,4,3,324,0
10,0,0,0,0,0,0,10,0
3,0,0,0,0,0,0,3,0
16,0,0,4,0,0,0,20,0
179,0,0,7,0,0,1,187,0
32,0,0,0,0,1,5,38,0
80,4,0,0,0,0,7,91,0
72,0,0,0,0,0,0,72,0
98,0,0,0,0,0,2,100,0
646,9,0,36,0,1,17,709,0
21,0,0,0,0,0,0,21,0
14,0,0,0,0,0,0,14,0
28,0,0,1,0,0,0,29,1
6,0,0,0,0,0,0,6,0
360,1,0,55,0,0,13,429,0
62,0,0,0,0,0,0,62,0
52,0,0,4,0,0,0,56,0
33,4,0,0,0,0,0,37,0
109,4,0,18,0,0,0,131,0
106,0,0,28,0,0,0,134,0
40,0,0,4,0,0,0,44,0
37,0,0,4,0,0,4,45,0
80,13,0,30,0,0,3,126,0
29,3,0,10,0,0,0,42,0
162,0,0,5,0,0,0,167,0
195,2,0,22,0,0,4,223,0
12,0,0,0,0,0,0,12,0
40,0,0,0,0,0,0,40,0
47,0,0,5,0,0,0,52,0
19,0,0,0,0,0,0,19,0
14,0,0,0,0,0,0,14,0
35,0,0,0,0,0,0,35,0
30,0,0,6,0,0,0,36,0
261,1,0,24,0,0,7,293,0
85,2,0,5,0,0,0,92,0
454,3,0,33,0,1,9,500,0
13,0,0,0,0,0,0,13,0
73,0,0,0,0,0,0,73,0
65,0,0,4,0,0,0,69,0
68,0,0,1,0,0,1,70,0
47,0,0,4,0,0,0,51,0
29,0,0,0,0,0,0,29,0
52,0,0,7,0,1,0,60,0
120,2,0,8,0,0,0,130,0
35,3,0,0,0,0,0,38,0
287,0,0,37,0,0,5,329,0
3,0,0,0,0,1,0,4,0
67,0,0,0,0,0,0,67,0
4,0,0,0,0,0,0,4,0
186,4,0,24,0,0,3,217,0
201,7,0,18,0,0,0,226,0
75,0,0,15,0,0,0,90,0
53,7,0,0,0,0,0,60,0
113,0,0,14,0,0,3,130,0
101,0,0,5,0,0,0,106,0
135,0,0,9,0,0,0,144,0
25,0,0,0,0,0,0,25,0
34,0,0,0,0,0,0,34,0
40,0,0,0,0,0,0,40,0
70,0,0,0,0,0,2,72,0
24,0,0,1,0,0,0,25,0
77,0,0,8,0,0,6,91,0
94,1,0,2,0,1,0,98,0
30,0,0,0,0,0,0,30,0
24,0,0,3,0,0,0,27,0
57,0,0,0,0,0,0,57,0
76,0,0,7,0,0,0,83,0
86,0,0,0,0,0,0,86,0
50,0,0,3,0,0,0,53,0
41,0,0,6,0,0,0,47,0
40,0,0,1,0,0,0,41,0
38,0,0,0,0,0,0,38,0
35,0,0,0,0,0,3,38,0
18,1,0,0,0,0,1,20,1
33,0,0,1,0,0,0,34,0
17,0,0,0,0,0,0,17,0
55,0,0,7,0,0,0,62,0
23,0,0,0,0,1,1,25,0
67,0,0,0,0,1,0,68,1
48,0,0,2,0,0,0,50,0
32,0,0,0,0,0,0,32,0
55,0,0,0,0,0,5,60,0
114,0,0,0,0,1,7,122,0
48,0,0,0,0,0,0,48,0
56,0,0,14,0,0,1,71,0
49,0,0,1,0,0,0,50,0
58,5,0,13,0,2,0,78,0
50,1,0,1,0,0,2,54,1
54,0,0,0,0,0,0,54,0
59,0,0,3,0,0,1,63,0
54,0,0,0,0,0,0,54,0
31,0,0,0,0,0,0,31,0
32,0,0,0,0,0,0,32,0
16,0,0,0,0,0,0,16,0
49,0,0,6,0,0,0,55,0
68,0,0,9,0,0,3,80,0
29,0,0,0,0,0,0,29,0
47,4,1,0,0,0,0,52,0
41,0,0,0,0,1,1,43,0
65,0,0,2,0,0,0,67,0
71,0,0,2,0,0,0,73,0
18,0,0,0,0,0,1,19,1
51,0,0,0,0,0,0,51,0
90,0,0,3,0,0,7,100,0
39,0,0,4,0,0,0,43,0
42,0,0,0,0,0,0,42,0
43,1,3,0,0,1,1,49,0
62,0,0,0,0,0,5,67,0
58,0,0,3,0,1,0,62,0
52,0,0,3,0,0,1,56,0
45,0,0,0,0,0,0,45,0
42,1,0,0,0,0,0,43,0
41,0,0,0,0,0,3,44,0
39,0,0,0,0,0,0,39,0
21,0,0,2,0,0,0,23,0
31,0,0,0,0,0,0,31,0
77,0,0,1,0,0,4,82,0
43,0,0,1,0,0,0,44,0
278,3,0,16,0,0,5,302,0
19,0,0,0,0,0,0,19,0
148,1,0,12,0,1,1,163,0
31,0,0,0,0,0,0,31,0
18,0,0,4,0,0,0,22,0
32,3,0,0,0,0,0,35,0
29,0,0,0,0,0,0,29,0
77,0,1,0,0,0,0,78,0
38,0,0,0,0,0,0,38,0
45,0,0,0,0,0,0,45,0
69,0,0,5,0,0,0,74,0
32,0,0,4,0,1,0,37,0
45,0,0,0,0,0,2,47,0
34,0,0,0,0,0,0,34,0
121,7,0,10,0,0,2,140,0
35,0,0,0,0,1,0,36,0
39,5,0,1,0,1,0,46,0
349,12,3,23,1,5,10,403,0
24,0,0,0,0,0,0,24,0
59,3,0,1,0,2,0,65,0
25,0,0,2,0,0,0,27,0
55,0,0,1,0,0,0,56,0
1,0,0,0,0,0,0,1,0
40,0,0,13,0,0,7,60,0
18,0,0,0,0,0,1,19,0
75,0,0,2,0,0,0,77,0
62,0,0,5,0,0,3,70,0
90,0,0,9,0,0,2,101,0
58,0,0,0,0,0,0,58,0
21,0,0,0,0,0,0,21,0
38,0,0,1,0,0,1,40,0
33,2,0,0,0,0,1,36,0
21,1,0,0,0,0,0,22,0
112,0,0,8,0,0,0,120,0
78,1,0,0,0,0,1,80,0
31,0,0,0,0,0,0,31,0
90,0,0,4,0,1,0,95,0
64,0,0,5,0,0,3,72,0
73,1,0,0,0,0,4,78,0
52,0,0,1,0,0,0,53,0
51,0,0,0,0,0,0,51,0
54,2,0,0,0,0,0,56,0
41,0,0,3,0,0,0,44,0
73,0,0,3,0,0,0,76,0
45,0,0,2,0,0,0,47,0
50,0,0,0,0,0,0,50,0
33,0,0,0,0,0,0,33,0
35,0,0,0,0,0,0,35,0
30,1,0,6,0,2,1,40,0
45,0,0,3,0,0,3,51,0
54,0,0,0,0,0,0,54,0
7,0,0,0,0,0,0,7,0
7,0,0,0,0,0,0,7,0
16,0,0,1,0,0,3,20,0
25,0,0,0,0,0,0,25,0
9,0,0,0,0,0,0,9,0
49,0,3,4,0,0,0,56,0
1,0,0,0,0,0,4,5,0
22,0,0,0,0,0,0,22,0
26,0,0,0,0,0,0,26,0
125,1,0,12,0,0,4,142,0
72,0,0,0,0,0,1,73,0
120,0,0,5,0,0,2,127,0
104,1,0,9,0,0,1,115,1
65,0,0,25,0,0,4,94,0
69,0,0,8,0,0,0,77,0
70,0,0,0,0,0,3,73,0
9,0,0,0,0,0,0,9,0
96,0,0,6,0,0,0,102,0
1,0,0,1,0,0,0,2,0
9,0,0,0,0,0,0,9,0
92,0,0,2,0,0,0,94,0
26,0,0,3,0,0,0,29,0
18,1,0,1,0,0,0,20,0
103,1,0,7,0,0,4,115,0
44,1,0,6,0,0,6,57,0
26,0,0,5,0,0,2,33,0
76,0,0,0,0,0,0,76,0
39,1,0,0,0,1,1,42,0
69,0,0,2,0,0,0,71,0
113,0,0,25,0,3,1,142,0
80,0,0,8,0,0,0,88,0
36,0,0,5,0,0,0,41,0
47,0,0,6,0,0,4,57,0
1,0,0,0,0,0,0,1,0
1,0,0,1,0,0,1,3,0
12,0,0,0,0,0,0,12,0
4,0,0,0,0,0,0,4,0
4,0,0,5,0,0,0,9,0
175,6,0,25,1,2,8,217,0
16,1,0,15,0,0,1,33,1
33,0,0,7,0,0,0,40,0
3,1,1,10,0,0,0,15,0
66,2,0,18,0,0,0,86,0
129,2,0,10,0,2,5,148,0
30,0,0,0,0,0,0,30,0
50,0,0,0,0,0,0,50,0
25,0,0,0,0,0,0,25,0
40,0,0,1,0,0,2,43,0
5,0,0,0,0,0,0,5,0
96,0,2,5,0,0,2,105,0
50,0,0,1,0,0,0,51,0
19,0,0,0,0,4,0,23,0
79,0,0,1,0,0,0,80,0
99,1,0,1,0,1,2,104,0
6,0,0,2,0,0,1,9,0
72,0,0,9,0,0,0,81,0
46,0,0,0,0,0,0,46,0
14,0,0,1,0,0,1,16,0
9,0,0,0,0,0,0,9,0
60,0,0,1,0,1,0,62,1
18,0,0,0,0,0,0,18,0
7,0,0,0,0,0,0,7,0
24,0,0,3,0,0,0,27,0
29,0,0,1,0,0,0,30,0
19,0,0,0,0,0,0,19,0
42,0,0,9,0,0,0,51,0
48,0,0,6,0,0,0,54,0
7,0,0,0,0,0,0,7,0
39,1,0,4,0,0,0,44,0
48,0,0,1,0,0,3,52,0
47,1,0,0,0,1,0,49,0
39,0,0,1,0,0,0,40,0
35,0,0,4,0,0,0,39,0
33,0,0,2,0,0,0,35,0
25,0,0,2,0,0,0,27,0
67,0,0,1,1,0,0,69,0
68,0,0,10,0,1,0,79,0
70,2,0,0,0,0,0,72,0
68,2,0,3,0,0,0,73,0
73,0,0,0,0,0,0,73,0
49,0,0,6,0,0,2,57,0
27,0,0,0,0,3,0,30,0
43,0,0,0,0,0,1,44,0
33,0,0,0,0,0,0,33,0
42,0,0,1,0,0,0,43,0
6,0,0,0,0,0,0,6,0
5,0,0,2,0,0,0,7,0
46,0,0,14,0,0,0,60,0
47,0,0,6,0,0,0,53,0
49,0,0,3,0,0,0,52,0
47,0,0,0,0,1,0,48,0
45,0,0,1,0,1,0,47,0
49,0,0,0,0,0,1,50,0
46,0,0,11,0,0,3,60,0
98,14,1,11,0,4,1,129,0
61,2,0,3,0,0,0,66,0
63,0,0,3,0,0,2,68,0
50,0,0,3,0,0,4,57,0
2,0,0,0,0,0,0,2,0
94,0,0,5,0,0,3,102,0
74,1,0,0,0,0,1,76,0
70,0,0,15,0,0,0,85,0
71,0,0,1,0,0,1,73,1
74,0,0,7,0,0,0,81,0
56,5,0,6,0,1,2,70,0
56,1,0,4,0,0,0,61,0
64,1,0,0,0,0,0,65,0
80,0,1,0,0,0,1,82,0
75,0,1,2,0,0,3,81,0
66,0,0,3,0,0,0,69,0
56,0,0,2,0,1,5,64,0
67,1,0,0,0,0,0,68,0
61,0,0,5,0,0,0,66,0
66,0,0,1,0,0,3,70,0
61,0,0,1,0,0,0,62,0
65,0,0,8,0,0,0,73,0
82,0,0,0,0,0,0,82,0
69,1,0,3,0,0,0,73,0
75,0,1,5,0,2,7,90,0
71,0,0,2,0,1,3,77,0
100,0,0,1,0,0,0,101,1
41,4,0,3,0,0,1,49,0
73,0,0,0,0,0,0,73,0
77,1,0,6,0,0,5,89,0
65,0,0,2,0,0,2,69,0
43,0,0,0,0,0,0,43,0
92,1,0,7,0,4,0,104,0
119,3,0,8,0,0,4,134,0
40,0,0,6,0,0,0,46,0
11,0,0,0,0,0,0,11,0
94,1,0,0,0,0,0,95,0
91,0,0,6,0,0,0,97,0
30,0,0,0,0,0,0,30,0
34,0,0,5,0,0,3,42,0
44,0,0,0,0,0,0,44,0
102,0,0,9,0,1,2,114,0
93,0,0,12,0,0,2,107,0
88,1,0,6,0,0,0,95,0
48,0,0,0,0,0,0,48,0
42,1,0,0,0,0,0,43,0
31,0,0,0,0,0,0,31,0
39,0,0,3,0,0,0,42,0
40,0,0,2,0,0,0,42,0
26,0,0,1,0,0,0,27,0
42,0,1,5,0,0,6,54,0
85,0,0,2,1,0,3,91,0
87,0,0,0,0,2,0,89,0
115,2,0,8,0,0,7,132,0
8,0,0,0,0,0,0,8,0
22,0,0,0,0,0,0,22,0
12,0,0,0,0,0,1,13,1
47,0,2,4,0,0,0,53,0
38,0,0,0,0,0,5,43,0
87,0,0,0,0,1,6,94,0
68,0,0,4,0,0,4,76,0
6,0,0,0,0,0,0,6,0
27,0,0,0,0,0,0,27,0
52,0,0,10,0,0,0,62,0
93,3,0,4,0,0,0,100,0
102,0,0,4,0,2,0,108,0
74,0,0,0,0,4,1,79,0
104,0,0,9,0,0,2,115,0
100,2,0,5,0,0,1,108,0
90,0,0,3,0,0,0,93,0
2,0,0,0,0,0,0,2,0
99,0,0,1,0,0,0,100,0
112,0,0,3,0,2,3,120,0
113,0,0,1,0,0,3,117,0
94,8,0,6,0,0,13,121,0
368,3,0,32,0,1,5,409,1
19,0,0,0,0,0,0,19,0
36,0,0,2,0,0,0,38,0
19,0,0,0,0,0,0,19,0
26,0,0,0,0,0,0,26,0
24,0,0,0,0,0,0,24,0
51,0,0,9,0,0,0,60,0
43,0,0,2,0,0,0,45,0
23,0,0,0,0,0,0,23,0
129,2,0,11,0,0,2,144,0
79,0,0,5,0,0,0,84,0
36,0,0,8,0,0,0,44,0
97,0,1,6,0,0,0,104,0
49,0,0,2,0,0,0,51,0
42,0,0,3,0,0,0,45,0
401,0,0,27,0,0,4,432,0
26,1,0,2,0,0,2,31,0
54,0,0,0,0,0,0,54,0
36,0,0,10,0,0,0,46,0
83,0,0,12,0,0,0,95,0
122,8,0,30,0,1,2,163,0
57,1,0,13,0,0,6,77,0
148,15,0,31,0,2,4,200,0
80,2,1,11,0,6,14,114,0
26,2,0,6,0,0,0,34,0
55,0,0,4,0,0,1,60,1
52,0,0,4,0,0,0,56,0
30,0,0,8,0,0,0,38,0
239,0,0,36,0,4,5,284,0
52,0,0,0,0,0,0,52,0
128,0,0,27,0,0,21,176,0
45,0,0,5,0,0,0,50,0
8,0,0,0,0,0,0,8,0
427,48,0,37,0,0,27,539,0
28,0,0,0,0,0,0,28,0
29,1,0,0,0,0,0,30,0
9,0,0,2,0,1,1,13,1
40,19,0,12,0,0,15,86,0
22,0,0,6,0,0,0,28,0
81,0,0,0,0,0,0,81,0
46,0,0,0,0,0,1,47,0
3,0,0,0,0,0,0,3,0
36,2,0,7,0,0,0,45,0
53,2,2,0,0,4,1,62,1
134,3,0,16,0,2,15,170,0
58,5,0,2,0,0,7,72,0
32,0,0,0,0,0,0,32,0
33,0,0,7,0,0,0,40,0
41,1,0,0,0,0,0,42,0
150,1,0,6,0,2,3,162,0
21,0,0,0,0,0,1,22,0
129,11,0,11,0,3,3,157,0
110,2,0,7,0,0,0,119,0
397,33,0,31,0,9,14,484,0
29,0,0,4,0,0,0,33,0
36,0,0,0,0,0,1,37,1
42,1,0,1,0,0,0,44,1
25,6,0,2,0,0,0,33,0
29,0,0,1,0,1,1,32,1
19,0,0,0,0,0,0,19,0
82,16,0,3,0,2,1,104,0
9,0,0,0,0,0,0,9,0
63,1,0,0,0,2,3,69,0
236,2,0,5,0,2,10,255,0
69,0,0,0,0,0,0,69,0
144,16,0,5,0,1,15,181,0
131,12,0,15,0,1,3,162,0
77,0,1,3,0,0,0,81,0
51,0,0,7,0,0,0,58,0
146,1,0,0,0,0,0,147,0
4,1,0,0,0,0,0,5,0
21,0,0,1,0,0,0,22,0
24,0,0,3,0,0,1,28,0
40,2,0,0,0,0,1,43,0
85,2,0,2,0,0,1,90,1
3,0,0,0,0,0,0,3,0
2,0,0,1,0,0,0,3,0
118,16,0,8,0,3,14,159,0
13,0,0,2,0,2,0,17,0
100,6,0,56,0,0,0,162,0
36,2,0,23,0,11,0,72,0
132,14,1,114,0,0,4,265,1
9,2,0,3,0,0,0,14,0
52,5,0,31,0,4,1,93,0
32,6,0,24,0,0,2,64,0
39,8,1,19,0,0,0,67,0
38,0,0,5,0,0,0,43,0
76,11,0,7,0,0,3,97,0
18,1,0,4,0,0,0,23,0
10,5,0,0,0,0,0,15,0
595,73,5,216,1,52,31,973,0
49,4,1,26,0,6,0,86,0
158,21,0,13,0,1,12,205,0
50,5,0,4,0,0,1,60,1
76,10,0,8,0,2,3,99,0
90,13,0,10,0,0,1,114,0
44,3,0,15,0,1,0,63,0
45,5,0,5,0,6,4,65,0
91,4,0,3,1,0,2,101,0
92,7,0,8,0,0,2,109,0
17,0,0,2,0,0,0,19,0
97,1,0,5,0,0,1,104,0
35,0,0,4,0,0,0,39,0
13,0,0,0,0,0,0,13,0
11,0,0,0,0,0,0,11,0
11,0,0,0,0,0,0,11,0
21,0,0,7,0,0,2,30,0
145,30,0,7,0,22,11,215,0
118,3,0,0,0,1,0,122,0
49,1,0,10,0,0,0,60,1
57,4,0,5,0,0,0,66,0
55,0,0,3,0,0,4,62,0
61,0,0,7,0,0,0,68,0
37,1,0,0,0,0,1,39,0
122,4,2,4,0,0,13,145,0
36,9,0,12,0,0,1,58,0
13,0,0,0,0,0,0,13,0
18,0,0,0,0,0,0,18,0
305,24,0,26,0,3,12,370,0
82,0,0,0,0,0,3,85,0
15,2,1,4,0,0,0,22,0
30,3,0,50,0,0,0,83,0
230,19,0,140,0,4,16,409,0
49,6,0,11,0,0,0,66,0
14,0,0,4,0,0,0,18,0
9,0,0,2,0,0,0,11,0
54,3,0,4,0,0,0,61,0
266,34,2,44,0,37,10,393,0
29,2,0,3,0,9,0,43,0
177,17,1,12,0,71,8,286,0
1,0,0,0,0,0,1,2,1
1,0,0,0,0,0,0,1,0
124,10,0,28,0,80,5,247,0
826,65,0,121,0,25,26,1063,0
11,0,0,0,0,0,0,11,0
34,3,0,1,0,1,0,39,0
98,21,0,16,0,6,18,159,0
16,1,0,2,0,0,0,19,0
136,10,0,24,0,11,10,191,0
43,2,0,4,0,6,1,56,0
361,32,1,17,0,3,25,439,0
84,10,0,9,0,18,5,126,0
74,8,0,3,0,3,2,90,0
2,0,0,0,0,0,0,2,0
40,5,0,2,0,0,0,47,0
2,0,0,0,0,0,0,2,0
89,0,0,11,0,0,5,105,0
2,0,0,0,0,0,0,2,0
37,0,0,2,0,0,0,39,0
21,1,0,0,0,0,2,24,0
26,0,0,1,0,0,0,27,0
97,12,0,7,0,0,2,118,0
31,0,0,0,0,0,0,31,0
73,7,0,5,1,1,7,94,0
335,24,0,32,0,3,8,402,0
44,0,0,4,0,0,6,54,0
27,6,0,7,0,0,1,41,0
179,1,0,14,0,0,4,198,0
48,0,0,2,0,0,0,50,0
127,16,0,2,0,8,4,157,0
85,2,0,4,0,0,0,91,0
37,0,0,4,0,0,1,42,0
22,0,0,0,0,0,0,22,0
23,0,0,6,0,0,1,30,0
80,1,0,7,0,0,4,92,0
45,0,0,10,0,0,1,56,0
64,9,1,23,0,1,3,101,0
75,6,0,10,0,0,0,91,0
5,0,0,0,0,0,0,5,0
25,0,0,6,0,0,2,33,0
14,0,0,1,0,0,0,15,0
3,0,0,0,0,0,0,3,0
5,0,0,0,0,0,0,5,0
2,0,0,0,0,0,0,2,0
12,0,0,0,0,0,0,12,0
3,0,0,0,0,0,0,3,0
5,0,0,0,0,0,0,5,0
7,1,0,1,0,0,1,10,0
2,0,0,0,0,0,0,2,0
2,0,0,0,0,0,0,2,0
1,0,0,0,0,0,0,1,0
4,0,0,0,0,0,0,4,0
7,0,0,0,0,0,0,7,0
40,0,0,4,0,0,2,46,0
243,8,0,37,0,9,13,310,0
379,11,0,28,0,8,12,438,0
51,10,0,0,0,0,0,61,0
112,18,0,39,0,5,11,185,0
53,5,0,1,0,3,1,63,1
20,2,0,0,0,0,3,25,0
1,0,0,0,0,0,0,1,0
0,2,0,0,0,0,0,2,0
68,0,0,7,0,5,2,82,0
296,40,0,49,1,105,27,518,0
0,2,0,0,0,2,0,4,0
47,7,0,14,0,4,2,74,0
67,1,0,4,0,0,4,76,0
236,28,1,57,4,18,7,351,0
9,1,0,7,0,0,0,17,0
40,5,0,5,0,0,2,52,0
13,0,0,0,0,0,0,13,0
1,0,0,0,0,0,0,1,0
7,0,0,0,0,0,0,7,0
94,0,0,1,0,0,3,98,0
55,0,0,9,0,0,0,64,0
1,0,0,1,0,0,2,4,0
94,21,0,0,0,6,0,121,0
314,40,4,167,0,13,19,557,0
141,5,1,115,0,10,7,279,0
64,8,0,12,0,0,10,94,0
393,128,0,34,0,95,36,686,0
48,22,0,0,0,0,1,71,0
3,0,0,0,0,0,0,3,0
61,9,0,13,0,1,1,85,0
81,11,0,13,0,0,8,113,0
30,6,0,28,0,0,0,64,0
24,0,0,0,0,0,0,24,0
18,0,0,4,0,0,0,22,0
18,0,0,5,0,0,1,24,0
79,4,0,10,0,6,4,103,0
95,7,0,0,0,0,4,106,0
142,21,0,10,1,7,2,183,0
44,11,0,14,0,0,4,73,0
22,7,0,3,0,4,12,48,0
109,24,0,9,0,9,8,159,0
18,0,0,6,0,0,1,25,0
12,0,0,0,0,2,1,15,0
24,4,0,0,0,2,0,30,0
10,0,0,0,0,0,0,10,0
85,10,0,19,0,4,6,124,0
28,0,0,19,0,0,1,48,0
43,0,0,12,0,0,0,55,0
13,1,0,0,0,0,0,14,1
242,4,0,20,0,2,4,272,0
15,0,0,0,0,0,0,15,0
28,0,0,0,0,0,0,28,0
42,0,0,0,0,0,0,42,0
432,31,0,51,0,19,28,561,0
407,21,3,140,0,9,11,591,0
56,0,0,13,0,0,1,70,0
41,0,0,7,0,0,2,50,0
64,0,0,6,0,0,0,70,0
27,0,0,20,0,0,0,47,0
86,13,0,12,0,5,6,122,0
147,19,0,16,4,37,17,240,0
54,0,0,0,0,0,0,54,0
18,0,0,0,0,0,0,18,0
250,53,2,7,0,45,14,371,0
225,31,1,30,0,11,5,303,1
71,12,0,5,0,6,2,96,0
108,14,1,55,0,9,9,196,0
4,0,0,2,0,0,0,6,0
74,10,0,9,0,0,5,98,0
78,8,0,19,0,0,2,107,0
132,10,0,3,0,4,5,154,0
46,9,0,16,0,0,0,71,0
19,1,0,5,0,0,0,25,1
30,0,0,16,0,0,0,46,0
90,5,0,3,0,0,1,99,0
106,0,0,35,0,0,5,146,0
29,0,0,6,0,0,0,35,0
52,8,0,4,0,0,5,69,0
134,4,0,6,0,0,5,149,0
125,4,0,17,0,0,3,149,0
27,3,0,5,0,0,0,35,0
31,0,0,0,0,0,0,31,0
36,0,0,3,0,0,0,39,0
66,2,0,2,0,0,0,70,0
757,33,1,185,0,9,14,999,0
29,0,0,7,0,0,0,36,0
26,1,0,1,0,0,0,28,0
3,0,0,0,0,0,0,3,0
83,3,0,37,0,0,3,126,0
67,0,0,27,0,0,0,94,0
358,20,0,57,0,2,7,444,0
74,0,1,0,0,3,2,80,0
42,3,0,0,0,0,2,47,0
10,0,0,0,0,0,0,10,0
15,0,0,0,0,0,0,15,0
69,0,0,0,0,0,0,69,0
49,7,0,0,0,0,0,56,0
166,6,0,24,0,2,6,204,0
619,102,1,58,0,79,48,907,0
62,3,0,9,0,0,1,75,0
94,12,0,5,0,12,1,124,0
93,11,0,8,0,6,2,120,0
12,4,0,0,0,2,0,18,0
162,14,2,9,0,62,7,256,0
101,4,0,3,0,0,2,110,0
68,4,0,4,0,4,0,80,0
53,0,0,3,0,0,2,58,0
66,4,0,1,0,0,5,76,0
69,12,0,3,0,6,3,93,0
60,17,0,0,0,0,5,82,0
28,1,0,10,0,3,1,43,0
27,1,0,0,0,10,0,38,0
173,11,0,3,0,4,11,202,0
32,0,0,0,0,0,1,33,1
22,0,0,0,0,0,0,22,0
78,1,0,0,0,0,0,79,0
26,4,0,0,0,1,0,31,0
36,5,0,0,0,0,1,42,0
91,4,0,8,0,0,6,109,0
31,0,0,6,0,0,4,41,0
24,0,0,0,0,0,0,24,0
30,0,0,0,0,0,0,30,0
111,3,2,0,0,10,3,129,0
383,52,3,19,0,30,25,512,0
98,0,1,0,0,0,0,99,0
43,1,0,3,0,0,3,50,0
314,23,1,31,0,27,19,415,0
33,0,0,2,0,0,1,36,0
78,7,0,9,0,2,7,103,0
122,17,0,15,0,1,2,157,0
45,4,0,2,0,8,0,59,0
6,0,0,0,0,0,0,6,0
20,7,0,3,0,0,3,33,0
41,0,0,0,0,0,0,41,0
29,0,0,0,0,0,0,29,0
53,0,0,0,0,0,0,53,0
239,8,0,28,0,10,5,290,0
64,1,0,13,0,5,0,83,0
57,7,1,13,0,2,0,80,0
187,36,0,14,0,4,6,247,0
201,16,0,5,0,2,1,225,0
74,6,2,2,0,1,8,93,0
48,0,1,6,0,0,0,55,0
36,0,0,2,0,0,0,38,0
27,0,0,3,0,0,0,30,0
162,41,1,8,0,2,10,224,0
468,47,3,93,0,34,30,675,0
9,0,0,0,0,0,0,9,0
133,5,1,0,1,0,3,143,0
92,0,0,7,0,0,0,99,0
70,1,0,5,0,0,0,76,1
135,6,0,13,0,2,0,156,0
33,0,0,0,0,0,0,33,0
37,2,0,7,0,0,2,48,0
136,1,0,20,0,0,6,163,0
51,0,0,4,0,0,0,55,0
85,2,0,8,0,1,2,98,0
41,0,0,4,0,0,5,50,0
277,13,0,96,0,4,15,405,0
47,0,0,0,0,0,0,47,0
29,0,0,0,0,0,0,29,0
58,0,0,12,0,0,3,73,0
45,7,0,5,0,0,0,57,0
59,6,0,10,0,0,1,76,0
34,7,0,0,0,0,0,41,0
100,5,1,1,0,5,0,112,0
123,2,0,2,0,0,2,129,0
38,0,0,2,0,2,0,42,0
52,0,0,7,0,0,3,62,0
35,0,0,6,0,0,0,41,0
154,8,0,3,0,0,3,168,0
22,0,0,0,0,0,0,22,0
214,11,0,14,0,19,5,263,0
202,11,0,5,0,5,1,224,0
9,0,0,0,0,0,2,11,0
0,0,0,2,0,0,0,2,0
0,0,0,0,0,0,1,1,0
106,0,0,0,0,0,3,109,0
251,10,3,23,0,1,13,301,0
8,0,0,0,0,0,0,8,0
21,0,0,5,0,0,0,26,0
42,1,0,0,0,0,1,44,0
31,0,0,0,0,0,0,31,0
0,0,0,0,0,4,0,4,0
120,1,0,5,0,0,1,127,0
207,0,0,12,0,0,2,221,0
46,1,0,8,0,0,1,56,0
64,2,0,15,0,0,1,82,0
162,5,0,18,0,0,3,188,0
656,61,0,110,0,20,42,889,0
45,5,0,1,0,0,0,51,0
53,1,1,7,0,0,1,63,0
60,2,0,0,0,0,4,66,0
32,4,0,0,0,0,0,36,0
26,4,1,6,0,1,1,39,1
90,3,0,20,0,6,4,123,0
18,5,0,6,0,0,5,34,0
88,2,0,22,0,1,2,115,0
116,10,0,28,0,5,12,171,0
319,22,1,28,0,0,6,376,0
1,0,0,0,0,0,0,1,0
3,0,0,0,0,0,0,3,0
45,0,0,50,0,2,2,99,0
34,5,0,1,0,0,0,40,1
4,0,0,0,0,0,0,4,0
86,8,0,15,0,0,5,114,0
93,0,0,39,0,0,3,135,0
70,6,0,18,0,4,0,98,0
5,0,0,6,0,0,0,11,0
33,3,0,16,0,0,0,52,0
45,7,0,26,0,0,1,79,1
64,6,0,23,0,1,6,100,0
1,0,0,0,0,0,0,1,0
36,6,0,20,0,0,8,70,0
11,0,0,0,0,0,0,11,0
21,0,0,0,0,0,0,21,0
3,0,0,0,0,0,0,3,0
94,17,0,17,0,0,3,131,0
83,0,0,12,0,0,0,95,0
58,4,0,0,0,0,0,62,0
175,5,0,7,0,0,8,195,0
244,14,0,16,0,33,9,316,0
61,1,0,14,0,0,1,77,1
100,33,0,1,0,11,4,149,0
33,5,0,3,0,0,0,41,0
329,22,0,43,0,11,5,410,0
1,3,0,0,0,0,4,8,0
19,0,0,10,0,0,0,29,0
2,0,0,0,0,0,0,2,0
130,8,0,11,0,0,0,149,0
24,0,0,0,0,3,0,27,0
120,4,0,25,0,0,6,155,0
43,5,0,17,0,0,3,68,0
159,1,0,50,1,4,3,218,0
84,0,0,9,0,0,5,98,0
72,5,0,25,0,0,2,104,0
13,0,0,21,0,0,0,34,0
3,0,0,0,0,0,0,3,0
1,0,0,0,0,0,0,1,0
80,8,1,17,0,0,6,112,0
296,94,1,19,0,44,43,497,0
53,5,0,4,0,2,0,64,0
20,0,0,6,0,0,1,27,0
50,16,1,2,0,42,7,118,0
127,6,0,15,0,0,5,153,0
115,16,0,8,0,6,5,150,0
103,15,0,7,0,0,0,125,0
137,32,0,4,0,34,11,218,0
192,12,0,14,0,1,7,226,0
34,0,0,1,0,0,0,35,0
65,0,0,0,0,0,0,65,0
43,0,0,0,0,0,0,43,0
54,0,0,1,0,0,1,56,0
49,1,0,3,0,0,4,57,0
70,8,0,1,0,1,2,82,0
83,4,0,10,0,0,2,99,0
143,0,0,4,0,0,3,150,0
79,1,0,0,0,0,1,81,0
71,0,0,4,0,4,3,82,0
13,0,0,0,0,0,0,13,0
30,0,0,0,0,0,0,30,0
123,0,0,4,0,0,6,133,0
47,0,0,3,0,0,3,53,0
35,0,0,0,0,0,0,35,0
223,1,0,11,0,0,9,244,0
5,0,0,0,0,0,0,5,0
10,0,0,0,0,0,0,10,0
9,0,0,0,0,0,0,9,0
0,0,0,1,0,1,0,2,0
4,0,0,0,0,0,0,4,0
7,0,0,0,0,0,0,7,0
104,2,0,23,0,0,0,129,0
26,0,0,2,0,0,0,28,0
8,0,0,3,0,0,0,11,0
94,0,0,10,0,0,0,104,0
4,0,0,0,0,0,0,4,0
8,0,0,1,0,0,0,9,0
43,3,0,2,0,1,0,49,0
10,0,0,0,0,0,0,10,0
0,4,0,0,0,0,0,4,0
70,0,0,0,0,0,0,70,0
81,0,0,0,0,0,0,81,0
8,0,0,0,0,0,0,8,0
641,29,6,134,0,13,22,845,0
62,0,0,3,0,0,0,65,0
306,13,2,74,1,3,11,410,0
202,1,0,0,0,0,0,203,0
113,0,0,10,3,0,1,127,0
59,5,0,10,0,0,0,74,0
2,0,0,0,0,0,0,2,0
52,0,0,3,0,0,0,55,0
39,1,0,13,0,2,1,56,1
207,4,0,11,0,1,2,225,0
8,1,0,1,0,0,0,10,0
50,1,1,4,0,2,3,61,1
14,0,0,0,0,0,0,14,0
6,0,0,0,0,0,0,6,0
20,0,0,3,0,0,0,23,0
23,0,0,0,0,0,0,23,0
4,1,0,0,0,0,0,5,0
3,0,0,0,0,0,0,3,0
15,0,0,0,0,0,0,15,0
28,4,0,6,0,0,0,38,0
29,0,0,4,0,0,0,33,0
26,0,0,0,0,0,1,27,0
63,3,0,1,0,0,1,68,0
43,0,0,1,0,0,2,46,1
44,0,0,0,0,1,2,47,0
33,0,0,1,0,0,3,37,0
141,0,0,0,0,1,3,145,0
52,0,0,2,0,0,0,54,0
8,0,0,0,0,0,0,8,0
13,3,0,0,0,0,0,16,0
2,0,0,0,0,0,0,2,0
14,0,0,0,0,0,0,14,0
75,8,0,7,0,0,0,90,0
89,0,0,4,0,1,0,94,0
123,1,0,0,0,2,1,127,1
83,0,0,0,0,0,0,83,0
67,0,0,6,0,0,0,73,0
50,0,0,0,0,0,0,50,0
32,2,0,0,0,0,0,34,0
44,0,0,0,0,0,0,44,0
26,0,0,0,0,1,0,27,0
2,0,0,1,0,0,0,3,0
103,6,0,4,0,0,0,113,0
357,11,0,3,0,1,8,380,0
48,0,0,0,0,0,0,48,0
40,0,0,0,0,0,0,40,0
62,3,0,0,0,0,0,65,0
21,0,0,0,0,0,0,21,0
10,0,0,0,0,0,0,10,0
67,0,0,2,0,0,4,73,0
33,0,0,2,0,0,5,40,0
2,0,0,0,0,0,0,2,0
9,0,0,1,0,0,1,11,0
26,0,0,1,0,0,0,27,0
30,0,0,1,0,2,0,33,0
112,0,0,5,0,0,1,118,0
46,3,0,0,0,0,0,49,0
2,0,0,0,0,0,0,2,0
28,0,0,0,0,0,0,28,0
23,0,0,0,0,0,0,23,0
20,0,0,0,0,0,0,20,0
21,0,0,0,0,0,0,21,0
570,17,0,35,0,4,7,633,0
10,0,0,0,0,0,0,10,0
3,1,0,1,0,0,1,6,0
39,2,0,0,0,0,0,41,0
19,0,0,0,0,0,0,19,0
36,0,0,27,0,1,6,70,0
34,0,0,3,0,0,0,37,0
15,5,0,0,0,0,0,20,0
114,0,0,4,0,1,1,120,0
34,0,0,0,0,0,0,34,0
72,0,0,0,0,0,0,72,0
105,0,0,0,0,0,0,105,0
48,0,0,0,0,0,0,48,0
45,5,0,9,0,0,1,60,0
107,0,0,0,0,0,0,107,0
92,0,0,0,0,0,4,96,0
64,0,0,2,0,0,0,66,0
1,0,0,0,2,0,0,3,0
2,0,0,0,0,0,0,2,0
4,0,0,0,0,0,0,4,0
113,11,0,2,0,2,6,134,0
71,0,0,9,0,1,1,82,0
36,12,0,2,0,0,0,50,0
94,5,0,14,0,0,1,114,0
6,0,0,0,0,0,0,6,0
13,0,0,19,0,0,0,32,0
136,4,1,51,1,0,5,198,1
46,5,0,8,0,1,1,61,0
28,3,0,22,0,4,0,57,0
10,3,0,2,0,0,0,15,0
22,0,0,7,0,0,0,29,0
21,0,0,2,0,0,0,23,0
13,0,0,23,0,0,0,36,0
18,1,0,0,0,0,2,21,0
296,20,0,15,0,6,10,347,0
46,2,0,6,0,0,7,61,0
79,0,0,11,0,0,0,90,0
167,7,0,27,0,0,2,203,0
62,0,0,7,0,0,0,69,0
57,0,0,0,0,0,0,57,0
41,0,0,4,0,0,2,47,0
133,1,0,0,0,0,3,137,0
7,0,0,0,0,0,0,7,0
44,0,0,0,0,0,3,47,0
8,0,0,0,0,0,0,8,0
92,4,1,5,0,0,0,102,0
258,3,0,31,0,0,4,296,0
72,3,0,14,0,4,0,93,0
19,0,0,3,0,0,0,22,0
28,1,0,1,0,0,2,32,0
94,0,0,4,0,0,0,98,0
80,1,0,9,0,0,1,91,0
137,5,0,14,0,0,0,156,0
40,3,0,5,0,0,4,52,0
54,0,0,3,0,0,0,57,0
188,6,0,11,0,0,6,211,0
6,0,0,0,0,0,0,6,0
198,0,0,19,0,0,2,219,0
29,0,3,0,0,0,0,32,0
204,8,0,13,0,1,9,235,1
10,0,0,0,0,0,0,10,0
95,4,0,8,0,0,0,107,0
60,6,0,5,0,0,3,74,0
38,0,0,11,0,0,2,51,0
93,0,0,7,0,0,0,100,0
39,1,0,1,0,0,0,41,0
35,1,0,4,0,4,0,44,0
11,0,0,0,0,0,0,11,0
131,0,1,12,0,0,2,146,0
57,0,0,9,0,0,0,66,0
29,0,0,0,0,0,0,29,0
37,0,0,0,0,0,0,37,0
251,1,0,9,0,0,0,261,0
2,0,0,0,0,0,0,2,0
3,0,0,0,0,0,0,3,0
0,0,0,2,0,0,0,2,0
16,0,0,0,0,0,0,16,0
10,0,0,0,0,1,0,11,0
25,2,0,0,0,0,0,27,0
6,0,0,0,0,0,0,6,0
3,0,0,0,0,0,0,3,0
347,7,1,24,0,0,2,381,0
36,0,0,4,0,0,0,40,0
21,0,0,0,0,0,1,22,0
58,1,0,3,0,0,0,62,0
13,0,0,0,0,0,0,13,0
30,0,0,0,0,1,5,36,1
2,0,0,0,0,0,0,2,0
8,0,0,0,0,0,0,8,0
100,2,0,2,0,3,1,108,0
659,22,0,74,4,2,22,783,0
54,0,0,0,0,0,0,54,0
5,0,0,8,0,0,0,13,0
55,0,0,2,0,0,0,57,0
29,0,0,1,0,0,0,30,1
125,16,0,22,0,0,13,176,0
1,0,0,0,0,0,1,2,0
53,8,0,11,0,0,2,74,0
58,1,0,3,0,0,2,64,0
87,0,0,8,0,0,0,95,0
61,0,0,3,0,0,0,64,0
135,4,8,6,0,1,4,158,0
30,4,0,6,0,0,0,40,0
33,0,0,4,0,0,0,37,0
76,2,0,3,0,0,0,81,0
9,2,0,7,0,0,1,19,0
162,34,0,32,0,6,10,244,0
60,6,0,6,0,0,6,78,0
142,4,1,0,0,0,1,148,1
45,2,0,0,0,0,0,47,0
42,0,0,0,0,0,0,42,0
23,0,0,3,0,0,0,26,0
50,2,0,0,3,0,0,55,0
29,0,0,3,0,0,0,32,0
60,7,0,0,0,0,0,67,0
13,0,0,3,0,0,0,16,0
66,1,0,0,0,0,0,67,0
61,0,0,0,0,0,0,61,0
250,9,0,55,0,0,12,326,0
31,3,0,7,0,0,0,41,0
12,0,0,3,0,0,0,15,0
114,0,0,17,0,1,2,134,0
30,0,0,0,0,1,2,33,0
162,2,0,4,0,0,5,173,0
25,0,0,0,0,0,0,25,0
46,2,3,17,0,0,0,68,0
88,0,0,50,0,1,5,144,0
145,3,0,32,0,1,0,181,0
194,22,1,44,0,0,4,265,0
53,7,0,0,0,0,1,61,1
103,5,0,0,0,0,0,108,0
14,0,1,2,0,0,0,17,0
86,8,0,1,0,0,4,99,1
126,2,1,1,0,0,0,130,1
93,0,2,11,0,0,1,107,0
50,6,1,1,0,13,1,72,0
28,0,0,1,0,0,3,32,1
33,6,0,3,0,0,1,43,0
122,3,0,11,0,0,3,139,0
39,0,0,5,0,1,2,47,0
31,0,0,4,0,0,0,35,0
3,0,0,0,0,0,0,3,0
0,0,0,3,0,4,0,7,0
47,0,0,0,0,0,3,50,0
129,14,0,2,0,0,1,146,0
100,1,0,1,0,0,0,102,0
201,2,2,5,0,0,9,219,0
4,0,0,0,0,0,0,4,0
5,0,0,0,0,0,0,5,0
277,22,0,22,0,3,10,334,0
6,0,0,0,0,0,0,6,0
2,0,0,0,0,0,0,2,0
69,2,0,5,0,0,3,79,0
2,0,0,0,0,0,0,2,0
110,5,0,8,0,4,4,131,0
4,0,0,0,0,1,0,5,1
175,18,1,10,0,0,5,209,0
238,9,0,10,0,0,7,264,0
83,2,0,5,0,0,0,90,0
42,0,0,5,0,0,0,47,0
34,1,0,0,0,0,2,37,0
36,0,0,0,0,0,0,36,0
31,0,0,9,0,7,1,48,0
64,4,0,0,0,3,3,74,0
52,2,0,1,0,0,0,55,1
102,10,0,3,0,0,3,118,0
103,11,0,11,0,0,19,144,0
25,1,0,4,0,0,0,30,0
35,0,0,0,0,5,3,43,0
143,12,0,7,0,0,5,167,0
15,6,0,0,0,4,0,25,0
18,2,0,0,0,1,2,23,0
37,0,0,7,0,1,3,48,0
89,0,0,8,0,0,0,97,0
117,7,0,6,0,5,6,141,0
68,0,0,5,0,1,0,74,0
85,2,0,0,0,1,3,91,0
485,22,0,60,0,6,14,587,0
44,1,0,6,0,0,2,53,1
47,5,0,27,0,0,8,87,0
53,0,0,13,0,2,7,75,0
8,2,0,0,0,0,0,10,0
38,0,0,0,0,0,0,38,0
31,1,0,1,0,0,2,35,1
65,1,0,11,0,0,3,80,0
19,0,0,3,0,0,0,22,0
55,0,0,12,0,1,7,75,0
43,1,0,7,0,1,1,53,0
20,0,0,5,0,0,1,26,0
62,2,0,16,0,1,2,83,0
26,4,0,0,0,0,0,30,0
12,0,0,7,0,0,0,19,0
118,2,2,18,0,4,2,146,0
16,3,0,12,0,0,0,31,0
50,9,1,4,0,0,0,64,0
16,1,0,2,0,0,0,19,0
0,3,0,3,0,0,0,6,0
44,0,0,14,0,0,0,58,0
115,14,1,29,0,9,11,179,0
160,7,0,7,0,1,0,175,0
36,1,0,6,0,0,0,43,1
32,0,0,0,0,0,0,32,0
0,0,0,0,0,5,0,5,0
18,0,0,5,0,0,0,23,0
2,0,0,0,0,0,0,2,0
15,0,0,0,0,0,0,15,0
10,0,0,0,0,0,1,11,0
10,0,0,0,0,0,0,10,0
4,0,0,2,0,0,0,6,0
51,1,2,0,0,3,2,59,0
39,2,0,5,0,7,0,53,0
150,6,0,25,0,5,6,192,0
90,13,1,29,0,7,2,142,0
45,0,0,22,0,0,0,67,0
57,4,0,27,0,10,2,100,0
150,13,2,51,0,21,16,253,0
68,8,0,22,0,2,2,102,0
49,1,0,5,0,0,1,56,2
85,7,0,18,0,2,3,115,0
30,0,0,17,0,4,0,51,0
55,5,0,8,0,1,1,70,0
26,1,0,0,0,0,0,27,0
76,10,0,26,0,0,7,119,0
31,0,0,0,0,0,0,31,0
29,0,0,7,0,0,0,36,0
65,2,0,32,0,0,3,102,0
2,2,0,0,0,0,1,5,1
195,10,1,26,0,15,10,257,0
169,6,0,37,0,4,10,226,0
20,2,0,3,0,0,2,27,0
164,18,1,14,0,6,2,205,0
63,11,0,4,0,0,0,78,0
124,2,0,7,0,0,12,145,0
1,0,0,2,0,0,0,3,0
27,2,0,0,0,0,0,29,0
74,2,0,5,0,0,0,81,0
0,0,0,0,0,0,1,1,0
76,4,0,11,0,0,0,91,0
29,0,0,0,0,0,0,29,0
64,10,0,8,0,0,0,82,0
82,2,0,4,0,0,0,88,0
127,2,0,0,0,3,5,137,0
24,0,0,0,0,0,1,25,0
40,2,0,0,0,3,0,45,0
8,0,0,0,0,0,0,8,0
1,0,0,0,0,0,1,2,1
0,0,0,0,0,0,1,1,0
4,0,0,0,0,0,0,4,0
76,0,0,6,0,0,0,82,0
32,4,0,0,0,3,0,39,0
244,13,0,73,0,0,0,330,0
108,0,0,1,0,0,2,111,0
27,1,0,9,0,0,1,38,0
13,0,0,0,0,0,0,13,0
19,0,0,4,0,0,0,23,0
14,0,0,4,0,0,0,18,0
53,0,0,8,0,0,1,62,1
52,1,0,2,0,0,0,55,1
13,0,0,2,0,0,0,15,0
39,2,0,7,0,0,2,50,0
42,0,0,0,0,0,1,43,1
29,0,1,1,0,0,0,31,0
105,7,0,5,0,0,1,118,0
237,12,0,15,0,0,19,283,0
26,2,0,0,0,2,6,36,0
43,2,0,20,0,7,3,75,0
138,9,1,21,0,5,9,183,0
33,0,0,4,0,0,3,40,0
33,0,0,5,0,0,1,39,0
45,1,0,15,0,3,2,66,0
156,0,0,23,0,0,2,181,0
37,5,0,10,0,1,0,53,0
22,0,0,0,0,0,0,22,0
212,6,2,15,0,11,12,258,0
50,5,2,0,0,0,0,57,0
154,6,0,16,0,2,4,182,0
125,33,0,14,0,33,12,217,0
43,0,0,1,0,0,0,44,0
18,0,0,0,0,0,0,18,0
26,0,0,1,0,0,0,27,0
24,0,0,1,0,0,7,32,0
19,0,0,0,0,0,0,19,0
57,0,0,0,0,0,0,57,0
40,0,0,1,0,0,2,43,1
21,0,0,0,0,0,0,21,0
41,0,0,0,0,0,0,41,0
54,0,0,0,0,0,0,54,0
11,0,0,0,0,0,3,14,0
46,0,0,0,0,0,0,46,0
52,0,0,0,1,0,0,53,0
65,0,0,0,0,0,0,65,0
48,0,0,4,0,0,0,52,0
40,0,0,0,0,0,0,40,0
40,0,0,0,0,0,0,40,0
25,0,0,0,0,0,0,25,0
44,0,0,0,0,0,0,44,0
27,0,0,0,0,0,0,27,0
37,0,0,0,0,0,0,37,0
42,0,0,2,0,0,0,44,0
174,3,0,5,0,4,7,193,0
27,0,0,1,0,0,0,28,0
16,1,0,6,0,0,0,23,0
206,3,0,12,0,1,9,231,0
95,0,0,1,0,0,4,100,0
67,0,0,5,0,0,2,74,0
5,0,0,0,0,0,0,5,0
45,0,0,0,0,0,0,45,0
61,1,0,4,0,0,1,67,1
36,0,0,4,0,0,0,40,0
51,0,0,0,0,0,0,51,0
74,1,0,3,0,0,0,78,1
51,0,0,6,0,0,0,57,0
49,0,0,1,0,0,0,50,0
51,1,0,0,0,0,2,54,0
53,1,0,2,0,5,0,61,1
68,0,0,2,0,0,6,76,0
41,0,0,0,0,0,0,41,0
16,0,0,0,0,0,0,16,0
18,0,0,1,0,0,0,19,0
209,12,0,7,0,0,3,231,0
12,0,0,1,0,0,0,13,0
11,0,0,0,0,0,0,11,0
35,0,0,0,0,0,0,35,0
30,0,0,0,0,0,0,30,0
42,0,0,0,0,0,0,42,0
48,1,0,0,0,0,2,51,0
49,1,0,0,0,1,2,53,0
48,0,0,0,0,0,0,48,0
71,1,0,15,0,0,0,87,0
27,0,0,4,0,0,0,31,0
32,0,0,0,0,0,2,34,0
60,0,0,0,0,0,0,60,0
39,0,0,3,0,0,2,44,0
57,0,0,4,0,0,0,61,0
133,2,0,0,0,0,2,137,0
20,0,0,0,0,0,4,24,0
15,0,0,0,0,0,0,15,0
33,0,0,0,0,0,0,33,0
48,0,0,7,0,0,0,55,0
17,2,0,0,0,0,0,19,0
23,0,0,0,0,0,0,23,0
72,0,0,11,0,1,3,87,0
28,0,0,1,0,0,2,31,0
92,0,0,2,0,0,0,94,0
63,0,3,12,0,0,0,78,0
64,0,0,11,0,0,2,77,0
65,0,0,6,0,0,1,72,0
65,0,0,0,0,0,0,65,0
81,0,0,3,0,0,0,84,0
93,0,0,6,0,0,4,103,0
1,0,0,0,0,0,0,1,0
104,0,0,4,0,0,3,111,0
65,0,0,0,0,1,0,66,0
57,0,0,0,0,0,0,57,0
70,0,0,0,0,0,3,73,0
62,0,0,0,0,0,0,62,0
51,0,0,0,0,0,0,51,0
47,0,0,0,0,1,0,48,0
46,0,0,4,0,0,0,50,0
46,1,0,0,0,0,1,48,1
147,3,0,0,0,0,1,151,0
153,1,0,0,0,3,3,160,0
59,0,0,2,0,0,0,61,0
64,0,0,0,0,0,4,68,0
68,0,0,0,0,8,0,76,0
63,0,0,0,0,0,0,63,0
52,0,0,0,0,0,0,52,0
61,0,0,3,0,0,0,64,0
62,1,0,0,0,0,2,65,0
34,0,0,1,0,0,2,37,0
67,0,0,0,0,0,0,67,0
52,0,0,4,0,0,0,56,0
47,0,0,0,0,0,0,47,0
59,0,0,0,0,0,0,59,0
121,0,1,10,0,3,3,138,0
58,2,0,7,0,0,0,67,0
46,0,0,1,0,0,0,47,0
44,1,0,11,0,0,0,56,0
25,0,0,1,0,1,2,29,0
83,0,0,6,0,0,1,90,0
142,3,0,38,0,0,10,193,0
118,3,0,28,0,1,8,158,0
17,0,0,0,0,0,0,17,0
22,0,0,3,0,0,0,25,0
25,0,0,0,0,0,0,25,0
23,0,0,5,0,0,0,28,0
89,0,0,4,0,0,0,93,0
115,2,0,12,0,0,3,132,0
115,2,3,61,0,4,6,191,0
100,0,0,51,0,0,9,160,0
45,2,0,12,0,0,4,63,0
12,0,0,1,0,0,0,13,0
27,0,0,0,0,0,0,27,0
69,2,1,1,0,0,0,73,1
64,0,0,1,0,0,0,65,0
64,0,0,0,0,6,0,70,0
60,0,0,0,0,0,1,61,1
41,0,0,0,0,0,0,41,0
44,0,0,1,0,0,0,45,0
66,0,0,0,0,0,0,66,0
70,0,0,4,0,0,0,74,0
66,0,0,0,0,0,1,67,0
77,0,0,0,0,0,0,77,0
73,0,0,2,0,0,0,75,0
67,0,0,0,0,0,0,67,0
63,0,0,4,0,0,4,71,0
19,0,0,0,0,0,0,19,0
85,0,3,0,0,0,0,88,0
37,0,0,3,0,1,0,41,0
34,0,0,0,0,0,0,34,0
51,0,0,2,0,1,4,58,0
21,0,0,2,0,0,0,23,0
37,0,0,0,0,0,0,37,0
54,0,0,0,0,0,0,54,0
52,0,0,0,0,0,0,52,0
38,0,0,0,0,1,3,42,0
51,0,0,0,0,0,0,51,0
50,0,0,0,0,0,0,50,0
39,0,0,0,0,0,0,39,0
69,0,0,0,0,4,3,76,0
56,0,0,2,0,0,0,58,0
56,0,0,0,0,0,0,56,0
63,0,1,0,0,0,0,64,0
38,0,0,0,0,0,0,38,0
70,0,0,3,0,0,0,73,0
30,0,0,0,0,0,0,30,0
37,0,0,0,0,0,0,37,0
50,0,0,1,0,0,0,51,0
66,0,0,0,0,0,0,66,0
54,0,0,2,0,0,0,56,0
108,0,0,0,0,0,0,108,0
46,0,0,0,0,0,0,46,0
37,1,0,1,0,0,1,40,0
87,0,0,0,0,0,0,87,0
115,0,0,1,0,1,0,117,1
98,0,0,0,0,0,0,98,0
97,0,0,1,0,0,0,98,1
9,0,0,0,0,0,0,9,0
36,0,0,0,0,0,0,36,0
46,0,0,0,0,0,0,46,0
8,0,0,0,0,0,0,8,0
46,2,0,2,0,0,0,50,0
60,2,0,7,0,0,0,69,0
4,0,0,0,0,0,0,4,0
39,0,0,1,0,0,0,40,1
56,0,0,0,0,0,0,56,0
93,0,0,4,0,0,0,97,0
84,0,0,0,0,0,3,87,0
87,0,0,0,0,0,0,87,0
67,1,0,0,0,0,0,68,0
62,0,0,0,0,0,0,62,0
52,0,0,0,0,0,0,52,0
23,0,0,0,0,0,0,23,0
79,0,0,0,0,0,0,79,0
63,0,0,2,0,0,4,69,0
50,1,0,14,0,0,0,65,0
72,7,0,0,0,0,1,80,0
77,0,0,0,0,0,0,77,0
14,0,0,0,0,0,0,14,0
42,0,0,0,0,0,0,42,0
9,0,0,0,0,0,0,9,0
32,0,0,0,0,0,0,32,0
30,0,0,0,0,0,2,32,0
41,0,0,0,0,0,0,41,0
15,0,0,0,0,0,0,15,0
68,0,0,0,0,0,2,70,0
128,0,0,10,0,0,7,145,0
130,0,0,1,0,0,0,131,0
39,0,0,0,0,0,0,39,0
33,0,0,4,0,0,0,37,0
46,0,0,0,0,0,3,49,0
90,1,0,2,0,0,1,94,0
39,0,0,0,0,0,0,39,0
45,0,0,0,0,0,0,45,0
76,1,0,0,0,0,2,79,0
41,0,0,0,0,0,0,41,0
59,0,0,0,0,0,0,59,0
34,0,0,0,0,0,0,34,0
47,0,0,1,1,0,2,51,0
38,0,0,0,0,0,0,38,0
79,0,0,3,0,0,0,82,0
43,0,0,4,0,0,0,47,0
90,3,0,3,0,0,3,99,0
49,0,0,1,0,0,1,51,0
44,0,0,0,0,0,4,48,0
45,0,0,0,0,0,0,45,0
49,0,0,0,0,0,0,49,0
40,0,0,0,0,0,2,42,0
48,0,0,1,0,0,0,49,0
49,0,1,2,0,0,4,56,0
42,0,0,0,0,0,0,42,0
27,0,0,0,0,0,0,27,0
51,0,0,0,0,0,0,51,0
7,0,0,0,0,0,0,7,0
50,0,0,0,0,0,0,50,0
32,0,0,0,0,0,0,32,0
30,0,0,0,0,0,0,30,0
22,0,0,0,0,0,0,22,0
37,0,0,1,0,0,0,38,0
42,0,0,0,0,0,0,42,0
46,0,0,0,0,0,0,46,0
55,0,0,0,0,0,0,55,0
43,5,0,0,0,0,0,48,0
4,0,0,0,0,0,0,4,0
41,0,0,1,0,0,0,42,0
42,0,0,0,1,0,0,43,0
33,3,0,1,0,0,0,37,1
34,0,0,0,0,0,0,34,0
54,3,0,3,0,0,2,62,0
2,0,0,0,0,0,0,2,0
4,0,0,0,0,0,0,4,0
82,0,0,0,0,0,2,84,0
51,0,0,0,0,0,0,51,0
19,0,0,0,0,0,0,19,0
38,0,0,0,0,0,0,38,0
28,0,0,0,0,0,0,28,0
49,0,0,0,0,0,0,49,0
51,0,0,2,0,2,0,55,0
54,0,0,0,0,0,0,54,0
34,0,0,0,0,0,3,37,0
41,0,0,0,0,0,0,41,0
43,0,0,0,0,0,1,44,1
85,0,0,0,0,0,0,85,0
76,0,0,3,0,0,4,83,0
27,0,0,0,0,0,0,27,0
39,0,0,0,0,0,0,39,0
53,0,0,0,0,0,3,56,0
317,22,0,0,0,0,0,339,0
20,0,0,0,0,0,0,20,0
18,0,0,1,0,0,3,22,0
14,0,0,5,0,0,0,19,0
6,2,0,0,0,0,0,8,0
23,0,0,0,0,0,0,23,0
12,0,0,3,0,0,0,15,0
11,1,0,0,0,0,0,12,0
7,0,0,0,0,0,0,7,0
5,0,0,0,0,0,0,5,0
60,1,0,3,0,0,0,64,0
186,20,0,2,0,4,15,227,0
38,0,0,4,0,0,1,43,0
71,0,0,3,0,0,2,76,0
116,9,0,3,0,1,3,132,0
41,0,0,0,0,0,0,41,0
34,0,0,1,0,0,2,37,0
40,0,0,1,0,0,0,41,0
38,0,0,2,0,0,1,41,0
61,0,0,3,0,0,3,67,0
27,1,0,0,0,3,0,31,1
51,0,0,3,0,0,1,55,0
83,6,0,0,0,0,0,89,0
81,0,0,2,0,1,2,86,1
44,0,0,6,0,1,0,51,0
265,16,0,18,0,2,21,322,0
38,0,0,0,0,0,1,39,0
86,0,0,3,0,2,0,91,0
49,9,0,1,0,0,0,59,0
61,0,0,0,0,0,0,61,0
16,7,0,0,0,0,0,23,0
60,0,0,0,0,1,0,61,0
66,0,0,0,0,2,0,68,0
20,0,0,0,0,0,0,20,0
1,0,0,0,0,0,3,4,0
50,1,0,1,0,0,1,53,0
53,3,0,0,0,0,1,57,0
78,0,0,0,0,0,1,79,0
20,0,0,0,0,0,0,20,0
37,0,0,0,0,0,0,37,0
90,0,0,0,0,0,0,90,0
68,2,2,0,0,3,5,80,0
19,0,0,0,0,0,1,20,1
21,0,0,0,0,0,0,21,0
43,0,0,0,0,0,0,43,0
75,0,0,0,0,0,4,79,0
19,2,0,0,0,0,0,21,0
24,1,0,0,0,0,0,25,0
27,0,0,0,0,0,0,27,0
26,0,0,0,0,0,0,26,0
41,0,0,0,0,0,0,41,0
43,0,0,0,0,0,0,43,0
26,0,0,0,0,1,0,27,0
50,3,0,1,0,0,3,57,0
30,0,0,0,2,0,0,32,0
19,3,0,0,0,0,1,23,0
7,0,0,0,0,0,0,7,0
171,0,1,6,0,0,2,180,0
51,4,0,0,0,0,0,55,0
9,0,0,0,0,0,0,9,0
31,0,0,0,0,0,0,31,0
6,0,0,0,0,0,0,6,0
25,0,0,1,0,0,0,26,0
76,3,0,2,0,0,0,81,0
42,0,0,1,0,0,0,43,1
52,2,0,5,0,0,0,59,0
60,1,0,3,0,0,3,67,1
2,0,0,0,0,0,0,2,0
149,19,0,0,0,1,1,170,1
46,0,0,5,0,0,2,53,0
50,0,0,2,0,0,2,54,0
32,0,0,0,0,0,0,32,0
94,0,0,2,0,0,0,96,0
62,1,0,0,0,0,1,64,1
45,0,0,0,0,0,0,45,0
86,3,0,0,0,0,0,89,0
85,0,0,0,0,0,0,85,0
83,0,0,0,0,0,0,83,0
48,0,0,2,0,0,5,55,0
50,0,0,0,0,0,0,50,0
79,2,0,1,0,0,5,87,1
28,0,0,3,0,0,0,31,0
39,0,0,0,0,0,0,39,0
287,0,0,5,0,1,6,299,0
60,0,0,0,0,0,0,60,0
65,0,0,0,0,0,3,68,0
110,3,0,9,0,0,5,127,0
78,0,0,0,0,0,1,79,0
78,0,0,1,0,0,3,82,0
53,0,0,0,0,0,0,53,0
85,0,0,8,0,0,6,99,0
47,0,0,1,0,0,0,48,0
423,2,0,7,0,0,6,438,0
46,0,0,0,0,0,0,46,0
67,0,0,0,0,3,0,70,0
42,0,0,1,0,0,0,43,0
71,1,0,2,0,0,1,75,0
56,0,0,0,0,0,3,59,0
55,0,0,0,0,0,0,55,0
88,0,0,1,0,0,1,90,1
236,5,0,4,0,0,0,245,0
110,3,0,4,0,0,2,119,0
4,0,0,0,0,0,0,4,0
114,2,0,2,0,0,0,118,0
77,0,0,3,0,0,0,80,0
72,2,0,2,0,0,0,76,0
184,15,0,8,0,1,0,208,1
49,2,0,0,0,0,0,51,0
49,1,0,4,0,0,2,56,0
106,3,0,1,0,0,0,110,0
74,0,0,0,0,0,3,77,0
12,0,0,0,0,0,0,12,0
115,1,0,2,0,0,4,122,1
7,0,0,0,0,0,0,7,0
92,40,0,14,0,3,9,158,0
222,15,1,8,0,6,28,280,0
24,0,0,1,0,0,0,25,0
79,5,0,5,0,1,2,92,0
24,5,0,0,0,0,0,29,0
240,22,0,4,0,5,7,278,0
266,0,0,7,0,6,4,283,0
34,0,0,0,0,0,1,35,0
11,0,0,0,0,1,3,15,0
157,3,0,0,0,0,2,162,0
133,6,0,4,0,2,4,149,0
36,1,0,0,0,0,0,37,0
46,0,0,1,0,0,0,47,1
53,0,0,0,0,0,0,53,0
61,0,0,0,0,0,1,62,1
234,4,0,3,0,1,9,251,0
100,1,0,0,0,0,0,101,0
44,0,0,9,0,0,1,54,0
32,0,0,0,0,0,0,32,0
100,1,0,2,0,1,3,107,0
43,1,0,3,0,0,0,47,0
10,0,0,0,0,0,1,11,0
48,2,0,0,0,0,3,53,0
27,4,0,0,0,0,0,31,0
44,0,0,0,0,0,0,44,0
38,0,0,0,0,0,0,38,0
36,1,0,0,0,0,1,38,2
39,0,0,0,0,0,0,39,0
59,1,0,0,0,0,2,62,0
0,0,0,0,0,0,2,2,0
10,0,0,0,0,1,0,11,0
21,0,0,0,0,0,0,21,0
28,0,0,0,0,0,0,28,0
67,0,0,0,0,0,4,71,0
140,1,0,4,0,0,2,147,0
111,0,0,2,0,0,1,114,1
119,0,0,0,2,3,1,125,0
21,0,0,0,0,0,0,21,0
17,0,0,0,0,0,0,17,0
129,0,0,0,0,0,1,130,0
85,0,0,0,0,0,0,85,0
25,0,0,0,0,0,0,25,0
37,0,0,1,0,0,1,39,0
62,1,0,0,0,0,2,65,0
53,0,0,0,0,0,0,53,0
45,0,0,0,0,0,0,45,0
35,0,0,0,0,0,0,35,0
14,0,0,0,0,0,0,14,0
22,0,0,0,0,0,0,22,0
300,139,1,22,0,3,26,491,0
109,60,0,8,0,4,12,193,0
113,169,1,7,0,9,23,322,0
122,184,1,11,0,18,31,367,0
75,29,0,0,0,3,2,109,0
70,19,1,5,0,0,3,98,0
68,4,0,1,0,0,1,74,0
12,0,0,0,0,0,0,12,0
34,0,0,1,0,0,0,35,0
91,1,0,1,0,0,0,93,0
44,6,0,1,0,0,4,55,0
127,6,1,0,0,1,0,135,0
50,0,0,1,0,0,0,51,0
145,3,0,6,0,0,0,154,0
22,0,1,2,0,0,0,25,0
27,0,0,1,0,1,0,29,0
107,2,0,2,0,0,5,116,0
78,3,0,1,0,0,0,82,0
2,0,0,0,0,0,0,2,0
11,0,0,0,0,0,0,11,0
31,4,0,0,0,0,0,35,0
31,2,0,0,0,0,0,33,0
56,3,0,0,0,1,0,60,0
439,9,1,3,0,2,4,458,0
101,7,0,2,0,0,9,119,0
70,1,0,0,0,0,0,71,0
92,1,2,0,0,2,0,97,0
35,0,0,0,0,1,6,42,0
41,0,0,0,0,0,0,41,0
62,0,0,0,0,0,2,64,0
61,0,0,1,0,1,1,64,0
52,0,0,0,0,0,0,52,0
25,0,0,0,0,0,0,25,0
55,0,0,0,0,0,0,55,0
152,6,0,4,0,0,7,169,0
76,3,0,0,0,0,2,81,0
50,0,0,1,0,0,0,51,0
82,2,0,3,0,0,3,90,0
73,2,0,2,0,0,1,78,0
41,4,0,0,0,0,0,45,0
56,0,0,0,0,0,0,56,0
210,7,0,3,0,0,6,226,0
51,1,0,0,0,0,2,54,1
86,0,0,0,0,0,2,88,0
54,6,0,1,0,1,2,64,0
68,5,0,0,0,0,1,74,0
68,0,0,1,0,0,0,69,0
62,3,0,3,0,0,0,68,0
50,1,0,1,0,1,3,56,0
46,0,0,0,0,0,0,46,0
61,2,0,2,0,1,0,66,0
72,10,0,1,0,0,0,83,0
17,0,0,0,0,0,0,17,0
49,0,0,0,0,2,1,52,1
152,1,0,2,0,0,5,160,0
63,0,0,7,0,0,0,70,0
27,0,0,1,0,3,0,31,0
52,2,0,4,0,0,3,61,0
201,3,0,8,0,0,6,218,0
12,0,0,0,0,0,0,12,0
37,0,0,0,0,0,2,39,0
48,0,0,0,0,0,0,48,0
77,1,0,3,0,2,6,89,0
85,0,0,2,0,0,3,90,0
2,0,0,0,0,0,0,2,0
2,0,0,0,0,0,0,2,0
33,0,0,3,0,0,0,36,0
23,0,0,0,0,1,0,24,1
20,0,0,0,0,0,0,20,0
29,0,0,1,0,0,0,30,0
58,0,0,0,0,0,0,58,0
31,0,0,0,0,0,0,31,0
76,0,0,0,0,0,1,77,0
34,0,0,0,0,0,0,34,0
54,0,0,0,0,0,0,54,0
34,1,1,0,0,0,0,36,0
88,1,0,0,0,0,1,90,0
29,0,0,0,0,0,0,29,0
31,0,0,2,0,0,0,33,0
0,0,0,0,0,0,1,1,0
19,0,0,0,0,0,0,19,0
12,0,0,0,0,0,0,12,0
35,0,0,0,0,0,1,36,0
32,0,0,1,0,0,1,34,0
23,0,0,2,0,0,0,25,0
29,0,0,0,0,0,0,29,0
355,148,1,14,0,66,16,600,0
74,5,1,1,0,0,3,84,0
40,12,0,0,0,0,2,54,0
166,27,0,10,0,5,13,221,0
78,52,0,0,0,10,9,149,0
2,0,0,0,0,0,0,2,0
45,1,0,2,0,0,0,48,0
118,14,0,9,0,1,9,151,0
19,0,0,0,0,0,0,19,0
28,0,0,0,0,3,2,33,0
76,1,0,1,0,0,1,79,0
14,4,0,0,0,0,0,18,0
33,1,0,0,0,0,0,34,1
133,121,1,14,0,52,31,352,0
37,63,0,2,0,58,4,164,0
211,136,0,3,0,74,22,446,0
83,30,3,0,0,10,12,138,0
15,0,0,0,0,0,0,15,0
14,0,0,0,0,0,0,14,0
57,9,0,0,0,0,8,74,0
103,14,0,2,0,0,0,119,0
110,3,0,1,0,0,2,116,0
22,2,0,0,0,2,0,26,0
142,2,0,1,0,4,5,154,0
29,2,0,0,0,0,1,32,0
100,0,0,3,0,0,2,105,0
25,0,0,0,0,0,1,26,1
83,0,0,1,0,0,2,86,0
35,0,0,0,0,0,0,35,0
34,3,0,0,0,0,0,37,0
89,29,0,6,0,0,3,127,0
14,0,0,0,0,0,1,15,0
75,57,0,4,0,4,8,148,0
35,5,0,7,0,0,1,48,0
116,25,1,0,0,0,2,144,0
84,25,1,0,0,0,0,110,1
43,21,0,0,0,0,0,64,0
82,56,0,6,7,8,5,164,0
56,21,0,2,0,0,4,83,0
87,58,5,11,0,8,7,176,0
162,149,0,13,0,40,27,391,0
65,23,0,12,0,1,3,104,0
90,38,1,0,0,0,0,129,0
75,13,0,0,0,1,4,93,1
45,4,0,0,0,0,4,53,0
32,16,0,4,0,0,3,55,0
90,28,2,8,0,0,1,129,0
145,97,3,2,0,10,16,273,0
55,28,0,1,0,0,1,85,1
55,9,0,0,0,0,1,65,1
126,54,0,3,0,0,0,183,0
54,29,0,1,0,0,2,86,0
64,19,0,0,0,0,9,92,0
36,12,0,7,0,0,0,55,0
66,26,0,6,0,0,4,102,0
65,19,0,0,1,0,2,87,0
52,13,0,7,0,1,0,73,0
61,21,0,0,0,5,4,91,0
48,8,0,0,0,0,0,56,0
62,8,1,4,0,0,0,75,0
135,15,0,0,0,7,0,157,0
69,12,0,0,0,0,0,81,0
39,18,0,1,0,0,5,63,0
100,35,0,0,0,3,5,143,0
62,36,0,2,0,5,4,109,0
145,85,1,0,1,8,11,251,0
45,44,0,2,0,6,2,99,0
78,17,0,7,0,5,7,114,0
114,62,0,5,0,1,5,187,0
51,17,0,0,0,2,1,71,0
79,68,0,3,0,0,6,156,0
48,34,0,0,0,0,0,82,0
49,15,0,0,0,0,2,66,0
58,22,0,0,0,3,0,83,0
60,37,0,7,0,0,6,110,0
28,10,0,6,0,0,0,44,0
274,506,1,23,0,10,46,860,0
142,203,0,2,0,20,20,387,0
43,35,0,2,0,3,9,92,0
111,53,1,5,0,0,0,170,0
54,21,0,0,0,4,6,85,0
44,11,0,0,0,0,0,55,0
75,14,0,4,0,13,2,108,0
10,19,0,0,0,0,0,29,0
241,691,3,19,13,62,38,1067,0
5,11,0,4,0,0,0,20,0
25,10,0,0,0,0,0,35,0
24,15,0,0,0,3,0,42,0
95,102,3,5,0,8,7,220,0
37,111,0,11,0,17,5,181,0
131,92,0,0,0,15,5,243,0
411,155,0,21,2,7,0,596,0
38,21,0,0,0,0,1,60,0
56,25,0,0,0,0,5,86,0
120,110,0,34,0,12,4,280,0
41,14,0,2,0,0,0,57,0
35,45,0,4,0,0,2,86,0
82,112,0,6,0,6,8,214,0
93,54,0,2,0,44,11,204,0
9,37,0,0,0,0,3,49,0
100,190,0,5,1,21,14,331,0
86,39,0,0,0,0,3,128,0
35,18,4,0,0,0,1,58,1
110,114,0,6,0,6,8,244,0
30,13,0,1,0,0,5,49,0
101,162,0,6,0,41,22,332,0
21,11,4,0,3,10,0,49,0
10,13,0,5,0,2,8,38,0
0,4,0,0,0,0,0,4,0
3,7,0,0,0,4,0,14,0
161,188,1,25,0,56,27,458,0
5,61,0,0,0,8,0,74,0
0,2,0,0,0,0,0,2,0
2,0,0,0,0,0,0,2,0
18,39,0,0,0,14,0,71,0
68,21,1,0,0,1,2,93,0
35,29,2,8,0,1,4,79,0
63,31,0,5,0,8,8,115,0
57,35,0,0,0,8,0,100,0
27,32,0,0,0,0,7,66,0
40,22,0,0,0,0,0,62,0
37,15,0,0,0,0,0,52,0
150,134,1,2,0,0,15,302,0
47,33,0,2,0,0,4,86,0
8,8,0,0,0,0,2,18,0
15,17,0,1,0,6,6,45,0
11,21,0,0,0,0,1,33,0
18,10,0,0,0,12,4,44,0
61,131,0,14,0,10,11,227,0
45,81,0,8,0,14,15,163,0
54,103,0,11,0,3,3,174,0
30,33,0,4,0,0,3,70,0
67,102,0,1,0,2,8,180,0
56,85,0,0,0,3,0,144,0
22,20,0,0,0,1,2,45,1
15,12,0,5,0,0,0,32,0
9,28,0,0,0,3,0,40,0
169,224,0,14,0,26,30,463,0
20,16,0,6,0,0,0,42,0
29,0,1,1,0,0,3,34,1
38,56,0,5,0,0,7,106,0
86,62,0,4,0,0,1,153,0
145,119,1,0,0,4,10,279,0
22,21,0,0,0,1,2,46,0
59,28,0,6,0,0,5,98,0
45,30,0,3,0,3,0,81,0
37,29,0,0,0,0,0,66,0
50,57,0,14,0,0,8,129,0
64,74,1,10,0,7,4,160,0
19,16,4,0,0,0,0,39,0
21,9,0,0,0,0,0,30,0
15,3,0,5,0,0,0,23,0
36,48,0,0,0,0,4,88,0
33,13,0,13,0,0,4,63,0
24,5,0,0,0,0,1,30,0
55,86,0,0,0,6,5,152,0
80,171,1,8,0,3,19,282,0
34,39,0,3,0,6,3,85,0
14,49,0,0,0,0,3,66,0
32,59,0,0,0,0,2,93,0
52,53,0,0,0,5,11,121,0
43,35,0,11,0,11,2,102,0
20,17,0,11,0,5,0,53,0
16,20,0,0,0,0,2,38,0
6,3,0,4,0,1,1,15,0
17,11,0,0,0,0,0,28,0
32,30,0,0,0,9,0,71,0
160,201,1,16,0,0,30,408,0
36,40,0,2,0,0,1,79,0
44,35,0,1,0,0,1,81,0
39,26,0,1,0,3,3,72,1
54,57,0,8,0,0,2,121,0
22,71,0,0,0,2,3,98,0
307,301,1,15,0,15,21,660,0
39,21,0,7,0,0,1,68,0
50,25,0,0,0,0,2,77,0
23,13,0,4,0,0,1,41,0
29,11,0,0,0,0,0,40,0
12,12,0,0,0,0,0,24,0
19,12,0,1,0,0,1,33,1
55,14,0,4,0,0,0,73,0
22,2,0,1,0,0,0,25,0
34,14,1,0,0,1,0,50,0
80,560,2,6,1,18,18,685,0
38,41,1,4,0,3,2,89,0
7,62,0,0,0,2,0,71,0
33,18,0,0,0,0,1,52,1
29,40,0,2,0,0,3,74,0
24,81,0,0,0,0,1,106,0
36,58,0,0,0,4,7,105,0
8,138,3,0,0,4,1,154,0
0,9,0,0,0,0,0,9,0
43,16,0,0,0,5,0,64,0
138,58,13,0,0,27,4,240,0
11,55,0,0,0,2,0,68,0
0,3,0,0,0,0,1,4,0
4,2,0,0,0,0,0,6,0
15,51,0,0,0,0,10,76,0
0,4,0,1,0,0,1,6,1
67,99,4,2,0,2,14,188,0
83,232,0,1,0,18,8,342,1
31,108,3,0,0,5,13,160,0
20,102,0,0,0,6,3,131,0
18,61,0,1,0,0,2,82,0
23,26,0,0,0,0,8,57,0
172,392,1,3,3,19,21,611,0
37,137,0,0,0,17,21,212,0
18,61,0,0,0,0,0,79,0
29,55,1,0,0,4,6,95,1
24,67,0,0,0,0,3,94,0
76,239,1,2,0,20,16,354,0
8,51,0,0,0,5,2,66,0
25,86,1,1,0,17,2,132,0
15,23,0,0,0,15,0,53,0
19,41,0,1,0,10,0,71,1
35,40,0,1,0,0,6,82,0
6,28,0,0,0,0,1,35,0
19,62,0,0,0,7,4,92,0
10,12,0,0,0,0,0,22,0
23,43,0,2,1,0,8,77,0
33,42,0,0,0,3,0,78,0
9,28,0,2,0,0,2,41,0
36,41,0,1,0,8,3,89,0
83,32,0,2,0,0,2,119,0
193,256,0,0,0,4,12,465,0
56,68,0,3,0,11,8,146,0
111,20,0,10,0,0,2,143,0
50,11,1,1,0,2,3,68,0
147,58,1,6,0,8,6,226,0
88,12,1,2,0,0,3,106,0
115,33,0,6,0,11,20,185,0
62,14,0,0,0,0,0,76,0
28,22,0,0,0,0,5,55,0
269,104,2,4,0,9,10,398,0
35,8,0,0,0,0,0,43,0
32,2,0,2,0,2,1,39,1
58,7,0,2,0,0,3,70,0
36,127,0,0,0,7,26,196,0
109,177,0,5,0,9,12,312,0
298,148,2,8,0,19,19,494,0
69,14,0,0,0,0,0,83,0
92,18,0,1,0,0,0,111,0
24,9,0,0,0,0,4,37,0
28,24,0,5,0,0,5,62,0
26,10,0,0,0,0,5,41,0
27,6,0,6,0,0,0,39,0
52,3,0,2,0,0,0,57,0
61,8,0,0,0,2,5,76,0
25,0,0,1,0,0,2,28,0
11,0,0,0,0,0,0,11,0
7,0,0,0,0,0,0,7,0
76,12,0,1,0,0,3,92,0
28,10,0,5,0,0,0,43,0
11,4,0,0,0,0,0,15,0
80,12,0,0,0,0,2,94,0
281,82,0,9,0,9,10,391,0
18,18,0,7,0,0,0,43,0
50,5,0,0,0,0,6,61,0
54,16,0,0,0,0,0,70,0
127,316,1,8,0,1,27,480,0
14,59,0,0,0,0,1,74,0
233,66,0,4,0,3,5,311,0
28,6,0,0,0,0,0,34,0
18,12,0,0,0,0,0,30,0
30,19,0,0,0,0,0,49,0
51,36,0,0,0,7,3,97,0
56,20,0,1,0,0,2,79,0
110,10,0,0,0,3,7,130,0
48,14,0,1,0,1,0,64,0
67,3,0,1,0,0,0,71,0
67,20,0,0,0,0,4,91,0
62,19,0,0,0,2,0,83,0
75,26,0,3,0,0,0,104,0
35,3,0,0,0,0,0,38,0
28,20,0,2,0,0,2,52,0
63,46,0,0,0,3,7,119,0
28,16,0,2,0,0,0,46,0
137,63,0,1,0,0,12,213,0
61,27,0,2,0,1,4,95,0
263,51,1,0,0,0,4,319,0
54,17,0,0,0,0,4,75,0
50,26,0,4,0,0,1,81,1
194,18,0,0,0,0,9,221,0
70,21,0,1,0,0,3,95,0
63,9,0,0,0,2,2,76,0
78,40,0,5,0,5,1,129,1
43,16,0,5,0,0,2,66,0
75,15,0,0,0,14,14,118,0
138,21,0,0,0,0,3,162,0
58,3,0,4,0,0,1,66,0
35,10,0,1,0,3,1,50,0
31,11,0,1,0,0,1,44,0
102,34,0,0,0,5,8,149,0
79,9,0,0,0,0,3,91,0
151,160,5,3,0,7,13,339,0
0,5,0,0,0,0,0,5,0
1,1,0,0,0,0,2,4,0
2,0,1,0,0,0,0,3,0
401,119,0,15,0,11,12,558,0
5,0,0,0,0,0,1,6,1
44,10,0,2,0,3,0,59,0
7,0,0,0,0,0,0,7,0
5,0,0,0,0,0,0,5,0
7,2,0,0,0,0,0,9,0
13,0,0,0,0,0,0,13,0
90,14,0,2,0,2,5,113,0
34,13,0,0,0,0,0,47,0
5,0,0,0,0,0,0,5,0
6,0,0,0,0,0,0,6,0
14,25,0,0,0,0,0,39,0
0,5,0,0,0,0,0,5,0
4,1,0,0,0,0,0,5,1
12,15,0,0,0,0,0,27,0
0,0,0,0,0,0,1,1,0
0,0,0,1,0,0,0,1,0
3,0,0,4,0,0,0,7,0
2,0,0,0,0,0,0,2,0
7,1,0,0,0,0,3,11,0
2,0,0,0,0,0,0,2,0
14,1,0,6,0,0,0,21,0
10,1,0,1,0,0,3,15,1
16,0,0,0,0,0,0,16,0
4,0,0,0,0,0,0,4,0
0,0,0,0,0,0,1,1,0
20,23,0,0,0,23,12,78,0
42,91,1,0,0,8,10,152,0
4,4,0,0,0,0,0,8,0
21,54,0,0,0,13,3,91,0
1,51,1,0,0,5,2,60,0
164,238,9,6,3,41,27,488,0
29,0,0,0,0,0,1,30,0
20,31,0,0,0,12,5,68,0
64,129,1,8,0,39,11,252,0
16,49,0,7,0,3,8,83,0
280,413,2,10,0,11,17,733,0
15,5,0,0,0,0,0,20,0
54,53,0,0,0,0,0,107,0
10,6,0,0,0,0,0,16,0
39,83,0,1,0,38,7,168,1
0,0,0,1,0,0,0,1,0
340,263,0,20,0,31,30,684,0
34,91,0,0,0,3,1,129,1
97,75,0,12,0,20,14,218,0
2,12,0,1,0,0,1,16,1
109,122,0,2,0,10,19,262,0
16,21,0,0,0,0,0,37,0
24,5,0,0,0,0,0,29,0
8,0,0,0,0,0,0,8,0
63,22,2,0,0,13,10,110,0
37,7,0,0,0,0,0,44,0
195,362,6,18,0,39,30,650,0
38,56,0,10,0,0,2,106,0
16,13,0,1,0,7,1,38,0
71,87,0,4,0,12,6,180,0
34,132,0,1,0,15,7,189,0
36,29,0,0,0,0,6,71,0
72,63,1,0,0,4,15,155,0
64,1,0,5,0,0,0,70,0
44,0,0,0,0,0,0,44,0
1,0,0,0,0,0,0,1,0
249,0,0,7,0,0,0,256,0
1,0,0,0,0,0,0,1,0
0,0,0,1,0,0,2,3,0
2,0,0,0,0,0,0,2,0
1,0,0,0,0,0,0,1,0
7,0,0,0,0,0,0,7,0
57,1,0,0,0,0,0,58,0
6,0,0,0,0,0,0,6,0
14,0,0,0,0,0,0,14,0
103,3,0,3,0,0,3,112,0
16,5,0,0,0,0,0,21,0
34,0,0,4,0,0,2,40,0
152,0,0,3,0,0,3,158,0
49,0,0,1,0,0,0,50,0
43,0,0,2,0,0,2,47,0
21,0,0,0,0,0,0,21,0
2,0,0,0,0,0,0,2,0
12,0,0,2,0,0,0,14,0
124,0,0,1,0,0,4,129,0
87,0,0,0,0,0,0,87,0
103,0,0,9,0,0,0,112,0
29,0,0,0,0,0,0,29,0
3,0,0,0,0,0,0,3,0
19,0,0,0,0,1,0,20,0
103,1,0,5,0,0,4,113,0
72,0,0,1,0,0,2,75,0
29,0,0,5,0,0,0,34,0
88,1,0,7,0,0,2,98,0
11,0,0,0,0,0,0,11,0
5,0,0,0,0,0,0,5,0
1,0,0,0,0,0,0,1,1
14,0,0,0,0,0,0,14,0
122,0,0,0,0,0,0,122,0
6,0,0,0,0,0,0,6,0
13,0,0,0,0,0,0,13,0
25,0,0,1,0,0,0,26,0
15,0,0,0,0,0,0,15,0
82,2,0,1,0,0,0,85,0
1,0,0,0,0,0,0,1,0
4,0,0,0,0,0,0,4,0
11,0,0,0,0,0,0,11,0
68,0,0,1,0,5,1,75,1
65,0,0,0,0,0,3,68,0
26,0,0,0,0,0,0,26,0
4,0,0,0,0,0,0,4,0
116,1,0,3,0,0,0,120,0
48,0,0,0,0,0,0,48,0
24,0,0,0,0,0,0,24,0
51,0,0,1,0,0,0,52,0
3,0,0,0,0,0,0,3,0
52,0,0,0,0,0,0,52,0
3,0,0,2,0,0,0,5,0
5,0,0,0,0,0,0,5,0
18,0,0,0,0,0,0,18,0
41,0,0,1,0,0,0,42,0
8,0,0,1,0,0,0,9,0
9,0,0,0,0,0,0,9,0
14,0,0,2,0,0,0,16,0
10,0,0,0,0,0,0,10,0
108,6,0,0,0,0,0,114,0
8,0,0,0,0,0,0,8,0
21,3,0,0,0,0,4,28,0
2,0,0,0,1,0,0,3,0
43,0,0,0,0,0,0,43,0
15,0,0,0,0,0,0,15,0
3,0,0,0,0,0,0,3,0
2,0,0,0,0,0,0,2,0
30,7,0,0,0,1,2,40,0
367,50,1,8,0,5,24,455,0
51,0,0,0,0,0,0,51,0
30,0,0,0,0,0,0,30,0
79,5,0,1,0,0,0,85,0
157,4,0,1,0,0,0,162,0
27,2,0,1,0,0,0,30,0
104,1,0,3,0,0,1,109,0
36,0,0,0,0,0,1,37,1
72,0,0,1,0,0,0,73,0
60,0,0,0,0,0,1,61,0
16,0,0,0,0,0,0,16,0
60,13,0,0,0,0,3,76,0
31,10,2,0,0,0,3,46,0
215,2,0,11,0,0,0,228,0
13,0,0,0,0,0,0,13,0
54,0,0,4,0,0,0,58,0
282,19,0,13,0,0,8,322,0
43,8,4,0,0,0,4,59,0
130,2,0,4,0,0,1,137,1
31,0,0,5,0,0,0,36,0
194,1,0,0,0,0,3,198,1
24,2,0,0,0,0,0,26,0
26,0,0,2,0,0,0,28,0
52,14,0,0,0,0,2,68,0
30,9,0,0,0,0,0,39,0
31,0,0,3,0,0,3,37,0
6,0,0,0,0,0,0,6,0
91,2,0,1,0,0,2,96,0
22,0,0,0,0,0,0,22,0
21,0,0,0,0,0,0,21,0
330,7,1,1,0,1,2,342,0
85,0,0,0,0,0,0,85,0
57,0,0,1,0,0,0,58,0
53,0,0,0,0,0,1,54,0
57,0,0,0,0,0,1,58,0
87,0,0,1,0,0,0,88,0
44,0,0,2,0,0,0,46,0
44,0,0,0,0,0,0,44,0
199,14,2,0,0,4,7,226,0
17,0,0,0,0,0,0,17,0
27,0,0,0,0,0,0,27,0
27,0,0,0,0,0,0,27,0
157,0,0,6,0,0,2,165,0
51,5,0,0,0,0,0,56,0
113,0,0,4,0,0,0,117,0
101,69,1,4,0,12,9,196,0
46,16,0,2,0,2,3,69,0
70,34,0,1,0,13,1,119,0
68,31,0,0,0,0,4,103,0
18,8,2,1,0,0,2,31,0
133,140,0,4,0,37,13,327,0
6,7,0,0,0,0,1,14,0
142,182,3,1,0,60,25,413,0
71,65,1,6,0,34,12,189,0
93,150,1,3,0,5,4,256,0
28,75,2,7,0,18,16,146,0
32,18,0,0,0,55,10,115,0
12,4,0,0,0,8,2,26,0
38,85,0,0,0,10,12,145,0
58,67,0,0,1,15,11,152,0
61,0,0,0,0,0,0,61,0
155,5,0,2,0,0,0,162,0
16,0,0,0,0,0,0,16,0
25,0,0,0,0,0,0,25,0
70,10,0,8,0,0,4,92,0
210,281,2,1,0,6,20,520,1
46,0,0,0,0,0,0,46,0
21,0,0,0,0,0,1,22,0
81,3,0,1,0,0,1,86,1
78,0,0,0,0,0,2,80,0
56,0,0,0,0,3,1,60,0
50,0,0,0,0,0,2,52,0
50,0,0,0,0,0,0,50,0
54,1,0,0,0,0,0,55,0
90,119,1,3,0,4,0,217,0
22,106,0,2,0,3,5,138,0
702,50,0,1,0,0,18,771,0
19,0,0,0,0,0,0,19,0
7,6,0,0,0,0,0,13,0
25,0,0,0,0,0,0,25,0
75,1,1,1,0,2,0,80,0
22,0,0,1,0,1,0,24,1
4,0,0,0,0,0,0,4,0
5,0,0,0,0,0,0,5,0
5,2,0,0,0,0,1,8,0
20,0,0,0,0,0,1,21,0
127,1,0,8,0,0,4,140,0
48,7,0,0,0,0,5,60,0
227,21,1,4,0,1,7,261,0
7,0,0,0,0,4,0,11,0
48,0,0,0,0,2,2,52,0
17,0,0,1,0,0,0,18,0
12,0,0,0,0,0,0,12,0
6,0,0,0,0,0,0,6,0
20,0,0,0,0,0,0,20,0
4,0,1,0,0,0,0,5,0
143,11,0,2,0,0,8,164,0
53,2,0,0,0,0,2,57,0
47,2,0,0,0,0,0,49,0
58,1,0,1,0,0,0,60,0
54,0,0,0,0,0,0,54,0
44,0,0,0,0,0,1,45,0
3,0,0,0,0,0,0,3,0
19,0,0,1,0,0,2,22,0
54,0,0,3,0,0,0,57,0
6,0,0,0,0,0,0,6,0
23,0,0,0,0,0,0,23,0
25,0,0,0,0,0,0,25,0
58,1,0,0,0,9,2,70,1
120,4,0,0,0,0,0,124,0
190,7,1,3,0,1,3,205,0
42,1,0,2,0,0,0,45,1
28,0,1,1,0,0,0,30,0
67,0,0,1,0,0,5,73,0
146,14,0,1,0,4,0,165,1
40,0,0,0,0,0,0,40,0
18,0,0,0,0,0,0,18,0
84,11,0,0,0,2,2,99,0
92,7,0,14,0,5,0,118,0
64,0,0,2,0,0,5,71,0
186,9,0,4,0,0,4,203,0
62,3,0,4,0,1,0,70,0
51,4,0,0,0,0,0,55,0
111,0,0,0,0,0,4,115,0
201,0,0,2,0,1,5,209,0
54,0,0,0,0,1,0,55,1
41,0,0,0,0,0,0,41,0
53,0,2,0,0,0,1,56,0
25,3,0,0,0,0,0,28,0
46,0,0,0,0,0,0,46,0
93,2,0,0,0,1,1,97,0
49,0,0,0,0,0,1,50,0
160,3,0,3,0,0,1,167,0
38,1,0,0,0,0,1,40,0
52,0,0,2,3,3,6,66,0
131,0,0,0,0,0,1,132,0
51,0,0,0,0,0,0,51,0
48,0,0,0,0,0,0,48,0
73,0,1,0,0,0,2,76,0
87,0,0,0,0,0,2,89,0
31,0,0,0,0,0,0,31,0
40,1,0,2,0,0,0,43,0
80,0,0,0,0,0,0,80,0
48,1,0,0,0,0,1,50,0
50,0,0,0,0,0,1,51,0
143,33,0,3,0,1,10,190,0
88,3,1,3,0,0,2,97,0
82,1,0,0,0,2,1,86,0
62,1,2,0,0,1,3,69,0
68,0,0,0,0,0,0,68,0
579,43,0,10,0,0,24,656,0
21,0,0,0,0,0,0,21,0
21,2,0,0,0,0,0,23,0
77,1,1,1,0,0,1,81,0
101,1,0,2,0,0,4,108,1
48,1,0,2,0,0,2,53,1
33,0,0,0,0,0,0,33,0
51,3,0,0,0,0,9,63,0
51,0,0,1,0,0,0,52,0
95,5,0,0,0,0,8,108,0
27,0,0,3,0,2,0,32,0
94,8,0,0,0,0,0,102,0
27,0,0,0,0,0,0,27,0
55,0,0,0,0,0,0,55,0
16,0,0,0,0,0,0,16,0
24,0,0,0,0,0,0,24,0
11,0,0,1,0,0,0,12,0
26,0,0,0,0,0,0,26,0
17,3,0,0,0,0,1,21,0
9,0,0,0,0,0,0,9,0
6,1,0,1,0,0,0,8,0
10,0,0,0,0,0,0,10,0
24,0,0,0,0,1,0,25,1
9,0,0,0,0,0,0,9,0
33,0,0,0,0,1,0,34,0
13,0,0,1,0,0,0,14,0
45,0,0,1,0,0,1,47,1
12,0,0,0,0,0,0,12,0
16,0,0,0,0,0,0,16,0
25,0,0,0,0,0,0,25,0
17,0,0,0,0,0,0,17,0
140,19,0,2,0,0,6,167,0
22,0,0,0,0,0,1,23,0
37,0,0,1,0,0,0,38,0
4,0,0,0,0,1,2,7,0
87,12,0,1,0,0,0,100,0
29,0,0,1,0,2,1,33,0
5,0,0,0,0,0,0,5,0
13,0,0,0,0,0,0,13,0
9,0,0,0,0,0,0,9,0
11,0,0,0,0,0,0,11,0
39,0,0,0,0,0,3,42,0
48,1,0,0,0,0,0,49,0
151,0,0,0,0,0,0,151,0
53,0,0,0,0,0,0,53,0
10,0,0,1,0,0,3,14,0
23,0,0,0,0,0,0,23,0
31,0,0,0,0,0,0,31,0
10,0,0,0,0,0,0,10,0
39,0,0,0,0,0,0,39,0
61,4,0,0,0,0,0,65,0
12,0,0,0,0,0,0,12,0
12,0,0,0,0,0,0,12,0
36,0,0,0,0,3,0,39,0
12,1,0,0,0,0,1,14,0
11,0,0,0,0,0,3,14,0
4,0,0,0,0,0,0,4,0
5,0,0,0,0,0,0,5,0
2,0,0,0,0,0,1,3,1
3,0,0,0,0,0,1,4,1
3,0,0,0,0,0,0,3,0
27,1,0,0,0,0,0,28,0
7,0,0,0,0,0,0,7,0
9,0,0,0,0,1,0,10,0
53,2,0,0,0,0,0,55,0
8,0,0,1,0,0,0,9,0
12,0,0,0,0,0,2,14,0
918,34,2,86,1,9,15,1065,0
25,0,1,9,0,0,0,35,0
91,0,0,8,0,0,3,102,0
34,2,0,2,0,0,0,38,0
8,0,0,9,0,0,0,17,0
23,8,0,7,0,0,1,39,0
88,2,1,10,0,0,2,103,0
24,1,0,0,0,0,2,27,0
12,0,0,0,0,0,0,12,0
27,0,0,0,0,0,0,27,0
342,8,1,13,0,1,4,369,0
26,1,0,0,0,0,1,28,0
73,0,0,12,0,0,0,85,0
63,3,0,8,0,0,1,75,0
19,0,0,0,0,0,0,19,0
21,0,0,0,0,0,0,21,0
103,11,0,9,0,4,6,133,0
2,0,0,0,0,0,0,2,0
3,0,0,0,0,0,0,3,0
63,29,1,8,0,14,8,123,0
5,0,0,0,0,0,0,5,0
235,40,1,19,0,1,6,302,0
4,0,0,0,0,0,0,4,0
42,6,0,0,0,4,5,57,0
306,39,2,26,0,62,21,456,0
5,0,0,0,0,0,0,5,0
244,29,0,8,0,28,12,321,0
0,0,0,2,0,0,0,2,0
100,16,0,10,0,4,5,135,0
74,12,0,0,0,0,0,86,0
28,5,0,0,1,0,0,34,0
26,0,0,0,0,0,0,26,0
27,4,0,5,0,0,1,37,0
433,88,0,30,0,29,31,611,0
220,26,0,26,0,7,10,289,0
59,14,0,0,0,7,0,80,0
246,13,1,21,0,2,8,291,0
35,0,0,0,0,0,0,35,0
33,5,0,7,0,0,0,45,0
26,0,0,0,0,0,0,26,0
53,3,1,5,0,0,0,62,0
3,0,0,0,0,0,0,3,0
128,9,0,3,0,0,0,140,0
144,15,1,25,0,0,2,187,0
1,0,0,0,0,0,0,1,0
5,0,0,0,0,0,0,5,0
4,0,0,0,0,0,0,4,0
65,1,0,9,0,0,0,75,0
9,0,0,0,0,0,0,9,0
42,2,0,0,0,0,5,49,0
12,1,0,0,0,0,0,13,0
7,4,0,0,0,0,1,12,0
23,2,0,1,0,0,0,26,0
8,0,0,0,0,0,0,8,0
6,0,0,0,0,0,0,6,0
60,2,0,15,0,0,1,78,0
10,0,0,0,0,0,0,10,0
3,0,0,0,0,0,0,3,0
45,6,0,11,0,0,0,62,0
105,10,0,8,0,0,0,123,0
3,0,0,1,0,0,0,4,0
48,4,0,7,0,0,0,59,0
56,29,0,74,0,0,3,162,0
31,2,0,24,0,0,4,61,0
33,6,0,35,0,3,3,80,0
488,76,3,46,0,4,11,628,0
34,10,1,22,0,1,1,69,1
23,11,0,14,0,1,1,50,0
50,14,0,11,0,0,2,77,0
40,6,0,4,0,0,0,50,0
44,21,0,19,0,0,0,84,0
28,3,0,0,0,0,2,33,0
19,5,0,6,0,0,1,31,0
50,5,0,0,0,0,0,55,0
54,6,0,20,0,0,4,84,0
77,8,0,4,0,0,1,90,0
18,2,0,1,0,0,1,22,0
27,6,0,4,0,6,0,43,0
39,4,0,9,0,0,0,52,0
30,3,0,0,0,0,0,33,0
2,0,0,0,0,0,0,2,0
532,49,0,80,1,5,20,687,0
16,0,0,0,0,0,0,16,0
97,21,0,21,0,4,5,148,0
11,0,0,1,0,0,1,13,1
16,1,0,6,0,1,0,24,1
8,0,0,0,0,0,0,8,0
50,8,1,12,0,1,0,72,0
87,3,0,7,0,5,7,109,0
116,4,0,3,0,0,0,123,0
26,38,0,0,0,0,3,67,0
38,7,0,5,0,0,0,50,0
6,0,0,0,0,0,0,6,0
11,4,0,0,0,0,0,15,0
1,0,0,0,0,0,0,1,1
4,0,0,0,0,0,0,4,0
323,19,0,74,0,6,4,426,0
90,28,1,119,0,4,4,246,0
75,13,1,72,0,3,0,164,1
46,30,0,7,0,1,5,89,0
116,0,0,5,0,0,2,123,0
127,5,0,15,0,0,8,155,0
42,5,0,2,0,0,0,49,0
18,6,0,0,0,0,0,24,0
30,2,1,9,0,0,6,48,1
46,11,0,0,0,1,4,62,0
99,4,0,24,0,2,5,134,0
33,1,3,8,0,0,0,45,0
229,10,0,31,0,0,1,271,0
104,1,0,16,0,0,0,121,0
48,0,0,14,0,4,0,66,0
56,4,0,7,0,0,9,76,0
104,5,0,3,0,2,1,115,0
42,0,0,2,0,0,3,47,0
46,11,0,0,0,0,1,58,0
42,2,0,0,0,0,1,45,0
166,6,0,27,0,0,2,201,0
41,3,0,0,0,0,0,44,0
32,0,0,0,0,0,0,32,0
52,0,0,0,0,0,0,52,0
152,5,0,9,0,0,0,166,0
188,3,1,4,0,0,5,201,0
6,0,0,0,0,0,0,6,0
3,0,0,2,0,0,0,5,0
42,3,0,0,0,0,1,46,1
273,47,0,27,0,2,12,361,0
94,38,0,32,0,7,0,171,0
33,2,0,2,0,3,0,40,0
2,0,0,0,0,0,2,4,0
81,0,0,0,0,0,0,81,0
92,2,0,29,0,0,4,127,0
652,136,0,45,1,107,23,964,0
64,18,0,6,1,0,2,91,0
71,23,0,3,0,0,5,102,0
52,13,0,2,0,14,2,83,0
83,24,2,14,0,9,4,136,0
431,49,1,18,0,10,16,525,0
21,1,0,7,0,0,0,29,0
148,20,0,13,0,1,3,185,0
89,9,0,8,0,0,0,106,0
56,0,0,6,0,6,1,69,0
22,1,0,7,0,0,0,30,1
48,0,0,0,0,0,3,51,0
20,0,0,0,0,0,0,20,0
204,24,0,18,0,1,5,252,0
20,3,0,4,0,0,2,29,0
25,10,0,3,0,8,3,49,0
21,1,0,2,0,0,2,26,0
51,0,0,3,0,0,0,54,0
211,19,0,16,0,5,10,261,0
34,7,1,4,0,0,3,49,0
45,1,0,0,0,0,1,47,0
19,7,0,4,0,0,0,30,0
85,5,0,5,0,0,0,95,0
33,5,0,0,0,0,0,38,0
98,6,1,7,0,0,6,118,0
50,5,0,2,0,0,3,60,0
23,0,0,0,0,0,1,24,0
27,0,0,0,0,0,0,27,0
20,0,0,0,0,0,0,20,0
176,5,1,14,0,1,0,197,0
39,4,0,1,0,0,1,45,1
43,5,1,0,0,0,1,50,0
351,52,1,8,0,11,15,438,1
6,0,0,0,0,0,0,6,0
23,0,0,1,0,0,5,29,0
18,0,0,2,0,0,0,20,0
18,1,0,2,0,0,0,21,1
10,5,0,4,0,0,5,24,0
18,0,0,0,0,0,6,24,0
16,6,0,0,0,0,0,22,0
19,5,0,0,0,0,0,24,0
89,7,0,1,0,0,4,101,0
168,29,0,3,0,1,7,208,1
30,15,0,4,0,0,6,55,0
158,26,0,58,0,6,11,259,0
40,8,0,12,0,0,1,61,0
41,15,0,0,0,0,0,56,0
37,6,0,0,0,0,1,44,0
1028,103,3,121,0,6,68,1329,0
81,2,0,5,0,0,0,88,0
132,39,0,23,0,2,5,201,0
14,0,0,1,0,0,1,16,0
118,5,0,7,0,0,0,130,0
50,24,0,31,0,1,2,108,0
10,0,0,0,0,0,1,11,0
40,0,0,15,0,0,2,57,0
61,7,0,41,0,6,0,115,0
117,13,0,2,0,0,2,134,0
19,0,0,7,0,0,2,28,0
21,0,0,3,0,0,1,25,0
50,0,0,26,0,0,1,77,0
26,13,0,19,1,0,4,63,0
51,9,0,32,0,0,3,95,0
29,4,0,1,0,0,0,34,0
34,4,0,1,0,0,0,39,0
66,1,0,0,0,0,0,67,0
40,5,0,0,0,0,0,45,0
48,13,0,7,0,0,3,71,0
23,7,0,0,0,1,3,34,0
29,8,0,1,0,3,1,42,1
70,136,2,6,0,0,5,219,0
20,79,0,0,0,10,2,111,0
90,242,2,13,0,7,14,368,0
12,36,0,0,0,1,5,54,0
26,64,0,15,0,5,0,110,0
65,0,0,0,1,0,5,71,0
267,233,0,44,1,13,25,583,0
17,7,0,0,0,0,10,34,0
11,8,0,8,0,0,4,31,0
45,17,0,0,0,0,4,66,0
49,0,0,0,0,0,0,49,0
48,118,0,1,0,0,9,176,0
3,0,0,0,0,0,0,3,0
18,16,0,1,0,0,4,39,0
0,1,0,0,0,0,1,2,1
32,0,0,6,0,0,5,43,0
63,12,0,0,0,0,0,75,0
16,82,0,0,0,7,5,110,0
24,93,0,0,0,3,0,120,0
0,3,0,0,0,0,0,3,0
171,13,0,4,0,0,10,198,0
201,105,2,1,0,1,1,311,1
35,0,0,0,0,0,0,35,0
145,9,0,1,0,0,3,158,0
112,5,0,0,0,2,1,120,0
227,8,1,13,0,2,10,261,0
35,0,0,4,0,0,0,39,0
14,4,1,0,0,0,0,19,0
82,8,0,0,0,0,0,90,0
37,0,0,0,0,0,0,37,0
101,12,0,0,0,0,5,118,0
25,0,0,0,0,0,0,25,0
20,13,2,0,0,0,4,39,0
47,4,0,0,0,0,0,51,0
11,43,0,0,0,2,5,61,0
8,30,0,0,0,5,2,45,0
46,14,0,1,0,0,0,61,0
71,48,0,17,0,5,1,142,0
151,78,0,25,0,12,9,275,0
5,0,0,0,0,0,0,5,0
16,3,0,4,0,5,4,32,0
30,20,0,0,0,0,2,52,0
5,11,0,0,0,5,1,22,0
17,33,0,13,0,0,6,69,0
69,169,1,10,0,2,10,261,0
32,50,0,1,0,3,2,88,0
20,23,0,0,0,0,0,43,0
19,64,0,1,0,2,11,97,0
1,11,0,0,0,2,3,17,0
16,13,0,15,0,1,1,46,0
34,49,0,0,0,0,1,84,1
7,0,0,0,0,0,1,8,1
10,43,0,0,0,0,3,56,0
1,5,0,0,0,0,0,6,0
36,0,0,1,0,0,0,37,0
3,0,0,0,0,0,0,3,0
19,0,0,0,0,0,0,19,0
3,0,0,8,0,0,0,11,0
15,0,0,0,0,0,0,15,0
3,0,0,0,0,0,0,3,0
15,0,0,0,0,0,0,15,0
22,1,0,0,0,1,3,27,0
3,0,0,0,0,0,0,3,0
4,0,0,0,0,0,0,4,0
43,10,0,0,0,0,2,55,0
0,1,0,0,0,0,0,1,0
259,108,3,21,0,11,28,430,0
39,32,0,1,0,0,5,77,0
21,13,0,0,0,12,2,48,0
152,33,5,4,0,5,3,202,0
43,25,0,0,0,6,6,80,0
38,44,0,0,0,6,4,92,0
23,14,0,0,0,0,0,37,0
19,14,0,0,0,0,0,33,0
10,1,0,0,0,0,0,11,1
25,67,2,0,0,0,9,103,0
514,308,1,20,0,29,39,911,0
31,32,0,15,0,4,1,83,0
49,34,0,7,0,0,7,97,0
0,0,0,0,2,0,0,2,0
543,512,1,19,0,9,31,1115,0
62,29,1,11,0,7,5,115,0
83,33,0,6,0,0,4,126,0
10,6,0,1,0,0,0,17,0
71,42,0,15,0,0,6,134,0
100,19,0,0,0,0,8,127,0
29,42,0,0,0,8,5,84,0
3,33,0,1,0,0,0,37,0
6,6,0,3,0,0,0,15,0
74,20,1,7,0,0,1,103,0
106,16,0,8,0,0,0,130,0
48,42,0,7,0,3,8,108,0
154,29,0,9,0,3,8,203,0
222,32,0,0,0,7,3,264,0
25,36,0,0,0,0,8,69,0
1,46,0,0,0,0,0,47,1
3,1,0,0,0,0,0,4,0
9,0,0,5,0,0,0,14,0
47,9,0,3,0,0,6,65,0
164,12,0,4,0,0,5,185,0
3,0,0,0,0,0,0,3,0
236,54,1,0,0,0,5,296,0
84,1,0,0,0,1,0,86,0
37,24,0,0,1,0,3,65,0
86,20,1,1,0,3,4,115,0
94,17,3,8,1,0,4,127,0
34,18,1,0,0,0,0,53,0
89,8,0,1,0,1,0,99,1
18,10,0,0,0,0,1,29,0
18,2,0,1,0,1,2,24,0
48,15,2,9,0,7,0,81,0
70,27,0,0,0,3,6,106,0
40,10,0,0,0,0,3,53,0
37,11,0,0,0,2,0,50,0
76,18,0,0,0,0,3,97,0
213,98,4,7,0,1,9,332,0
62,18,0,6,0,0,3,89,0
96,46,0,1,0,16,9,168,0
54,7,0,3,0,0,0,64,0
84,62,0,5,0,0,11,162,0
130,82,1,1,0,17,23,254,0
29,4,0,0,0,0,5,38,0
28,0,0,1,0,0,0,29,0
19,4,0,0,0,0,0,23,0
131,17,0,4,0,0,1,153,1
28,11,1,0,0,2,1,43,0
38,163,0,0,0,0,3,204,0
128,110,0,5,0,7,15,265,0
10,14,0,0,0,0,1,25,0
1,31,0,0,0,0,1,33,1
11,76,0,0,0,0,3,90,0
4,47,0,0,0,0,0,51,0
52,22,0,0,0,2,3,79,0
51,12,0,6,0,5,2,76,0
395,80,2,13,0,14,8,512,0
20,17,0,4,0,0,6,47,0
23,12,0,0,0,0,0,35,0
12,7,0,0,0,0,1,20,0
24,6,0,0,0,1,1,32,1
16,2,0,0,0,0,0,18,0
32,2,0,8,0,0,0,42,0
16,9,0,5,0,7,3,40,0
47,27,0,9,0,0,0,83,0
22,5,0,2,0,0,0,29,0
38,6,0,0,0,0,0,44,0
12,4,0,2,0,0,0,18,0
38,6,0,0,0,0,0,44,0
43,11,0,7,0,0,0,61,0
0,29,0,0,0,0,0,29,0
16,0,0,0,0,0,3,19,0
25,5,0,0,0,0,0,30,0
3,0,0,0,0,5,0,8,0
263,2,0,0,0,0,0,265,0
7,26,0,0,0,7,2,42,0
3,24,0,0,0,2,0,29,0
94,93,2,8,0,3,8,208,0
8,4,0,0,0,0,0,12,0
38,62,1,4,0,0,9,114,0
96,96,0,2,3,4,10,211,0
66,14,0,0,0,5,6,91,0
222,574,0,4,4,65,43,912,0
4,0,0,0,0,0,0,4,0
2,0,0,0,0,6,0,8,0
4,22,0,0,0,2,0,28,0
16,9,0,0,0,0,1,26,0
0,4,0,1,0,0,2,7,0
3,0,0,0,0,0,0,3,0
43,25,0,3,2,4,4,81,0
13,8,0,1,0,1,0,23,0
43,37,0,0,0,0,3,83,0
116,40,0,5,0,6,3,170,0
20,5,0,0,0,2,0,27,0
17,3,0,0,0,6,3,29,0
88,42,0,3,0,11,9,153,0
52,120,0,2,0,13,17,204,0
8,1,0,0,0,0,0,9,0
19,10,0,0,0,0,1,30,0
42,2,0,0,5,0,0,49,0
32,0,0,6,0,0,0,38,0
0,5,0,0,0,0,0,5,0
36,100,0,0,0,30,12,178,0
39,80,1,0,0,37,10,167,0
5,7,0,8,0,0,0,20,0
130,30,1,3,0,0,3,167,0
2,0,0,0,0,0,0,2,0
48,26,0,4,0,0,2,80,0
2,0,0,0,0,0,0,2,0
0,1,0,0,0,0,1,2,0
1,0,0,0,0,6,0,7,0
11,5,0,1,0,0,0,17,1
22,5,0,0,0,0,0,27,0
38,28,0,0,0,0,3,69,0
0,0,0,0,0,0,1,1,0
93,39,0,0,0,7,11,150,0
67,59,0,0,0,1,15,142,0
49,34,0,0,0,3,10,96,0
71,50,1,2,0,0,8,132,0
5,1,0,0,0,0,1,7,2
71,45,0,6,0,6,7,135,0
2,5,0,0,0,0,0,7,0
24,40,0,0,0,4,2,70,0
51,38,2,0,0,17,5,113,0
24,7,0,1,0,0,0,32,1
15,58,0,0,0,0,0,73,0
1,0,0,0,0,0,0,1,0
0,1,0,0,0,0,0,1,1
210,187,0,16,0,27,24,464,0
91,215,1,3,0,33,14,357,0
105,0,0,0,0,7,6,118,0
217,33,0,2,0,0,8,260,0
14,0,0,0,0,0,0,14,0
14,0,0,0,0,1,2,17,1
152,13,0,0,0,1,2,168,0
44,12,0,2,0,0,0,58,0
60,2,0,0,0,0,1,63,0
44,0,0,0,0,1,2,47,0
64,8,0,0,0,0,0,72,0
85,6,0,1,0,0,4,96,0
104,3,0,14,0,0,1,122,0
66,16,0,0,0,1,7,90,0
70,4,2,0,0,0,0,76,0
167,4,0,0,0,0,1,172,0
209,19,0,1,0,1,23,253,0
56,3,0,2,0,2,0,63,0
69,7,0,0,0,0,0,76,0
57,0,0,6,0,0,0,63,0
79,15,0,1,0,0,1,96,1
13,0,0,1,0,0,0,14,1
173,22,0,0,0,1,4,200,0
25,6,0,0,0,0,0,31,0
93,25,0,0,0,0,9,127,0
67,13,0,6,0,0,1,87,1
51,8,0,0,0,0,5,64,0
77,1,0,0,0,7,7,92,1
70,5,0,3,0,0,0,78,0
53,0,0,0,0,0,0,53,0
136,8,0,0,0,6,2,152,0
27,14,0,0,0,0,0,41,0
21,0,0,2,0,0,1,24,0
57,21,0,0,2,0,1,81,0
43,3,0,0,0,0,0,46,0
16,0,0,0,0,2,0,18,0
208,161,0,3,0,20,36,428,0
72,26,0,4,0,4,4,110,0
166,10,0,1,0,6,5,188,0
38,0,0,0,0,0,2,40,0
53,5,0,0,0,3,0,61,0
63,0,0,7,0,0,4,74,0
134,0,0,2,0,0,1,137,1
76,11,0,0,0,0,0,87,0
59,4,0,0,0,0,0,63,0
82,0,0,1,0,0,4,87,0
187,78,2,10,0,14,30,321,0
23,4,0,0,0,0,1,28,0
31,8,0,3,0,0,7,49,0
58,49,0,0,0,0,8,115,0
79,15,2,0,1,2,5,104,0
91,0,0,0,0,0,0,91,0
100,2,0,0,0,0,0,102,0
120,8,0,9,0,0,1,138,0
96,23,3,0,0,0,4,126,0
44,1,0,1,0,0,0,46,0
47,0,0,0,0,1,4,52,0
23,2,0,0,0,0,3,28,0
85,8,0,3,0,5,2,103,0
129,29,1,8,0,11,8,186,0
33,12,0,7,0,0,5,57,0
28,23,0,0,0,0,8,59,0
76,9,0,0,0,0,4,89,0
51,0,0,1,0,0,3,55,1
59,13,0,1,0,0,6,79,0
44,0,0,0,0,0,0,44,0
56,1,2,0,0,0,5,64,0
39,4,0,9,0,0,1,53,0
48,1,0,0,0,0,0,49,1
45,13,0,0,0,1,0,59,0
413,78,7,88,0,14,31,631,0
101,24,0,36,0,0,3,164,0
31,16,0,13,0,0,0,60,0
44,4,0,1,0,1,3,53,0
59,24,1,31,0,1,3,119,0
48,8,0,2,0,3,0,61,0
66,55,0,17,0,1,1,140,0
93,12,0,1,0,0,1,107,0
96,11,0,2,0,0,1,110,0
311,37,0,3,0,0,11,362,0
32,1,0,0,0,0,0,33,0
381,17,0,4,0,0,10,412,0
9,0,0,0,0,0,0,9,0
9,11,0,0,0,0,0,20,0
27,0,0,0,0,0,0,27,0
38,0,0,0,0,0,0,38,0
27,2,0,1,0,0,0,30,1
200,11,0,14,0,0,3,228,0
24,7,0,3,0,0,0,34,0
29,4,0,0,0,0,0,33,0
406,73,2,35,0,6,16,538,0
8,1,0,0,1,0,0,10,0
20,2,0,5,0,0,0,27,0
97,45,0,15,0,0,2,159,0
10,2,0,0,0,0,0,12,0
13,0,0,1,0,0,0,14,0
5,0,0,0,0,0,0,5,0
24,5,0,8,0,0,1,38,0
48,7,0,0,0,0,0,55,0
87,15,1,0,0,1,3,107,0
14,10,0,2,0,4,1,31,0
11,4,0,4,0,1,0,20,1
41,7,0,1,0,0,0,49,0
25,6,0,0,0,0,3,34,0
86,24,1,8,0,0,9,128,0
32,5,0,6,0,0,0,43,0
5,3,0,4,0,6,1,19,0
28,2,0,1,0,4,0,35,0
11,3,0,0,0,0,0,14,0
1,1,0,0,0,0,0,2,0
0,0,0,0,0,0,2,2,0
55,17,0,3,0,0,0,75,0
66,10,0,0,0,0,4,80,0
116,11,0,2,0,2,1,132,1
80,4,0,3,0,3,2,92,0
71,11,0,8,0,0,1,91,0
146,21,0,6,0,5,5,183,0
132,19,0,5,0,1,13,170,0
70,17,0,3,0,0,2,92,0
85,4,0,6,0,0,0,95,0
121,13,0,7,0,7,3,151,0
129,76,1,33,0,8,19,266,0
147,25,0,19,0,13,10,214,0
90,37,1,8,0,1,7,144,0
50,16,0,1,0,0,1,68,0
16,7,0,7,0,0,0,30,0
40,10,1,5,0,0,7,63,0
80,2,0,0,0,2,0,84,0
0,3,0,0,0,0,0,3,0
27,0,0,0,0,1,0,28,0
7,4,0,0,0,0,0,11,0
7,0,0,0,0,0,0,7,0
28,15,0,0,0,0,0,43,0
200,7,1,1,0,0,11,220,1
230,8,0,4,0,1,3,246,0
282,10,0,3,0,0,6,301,0
34,2,0,1,0,0,0,37,0
36,0,0,0,0,0,0,36,0
186,0,0,4,0,1,0,191,0
36,0,0,0,0,0,0,36,0
50,1,0,1,0,0,1,53,1
98,1,0,0,0,0,4,103,0
23,0,0,0,0,0,0,23,0
115,3,0,2,0,0,3,123,0
43,3,0,0,0,0,0,46,0
88,0,2,1,0,0,5,96,0
30,1,0,0,0,0,0,31,0
44,0,0,3,0,0,0,47,0
59,0,0,2,0,0,0,61,0
81,9,0,1,0,0,3,94,0
114,0,0,2,0,0,6,122,0
14,0,0,0,0,0,0,14,0
29,0,0,0,0,0,0,29,0
37,0,0,0,0,0,0,37,0
48,0,0,0,0,0,0,48,0
16,0,0,0,0,0,0,16,0
40,18,0,1,0,0,0,59,0
1,0,0,0,0,0,1,2,1
98,13,2,1,0,0,2,116,0
12,0,0,0,0,0,3,15,0
112,36,0,8,0,0,4,160,0
19,0,0,3,0,5,0,27,0
107,8,1,6,0,0,3,125,0
109,5,0,0,0,1,0,115,0
43,0,0,0,0,0,3,46,0
26,0,0,0,0,0,1,27,1
31,0,0,0,0,0,0,31,0
164,5,0,4,0,0,0,173,0
18,5,0,0,0,0,0,23,0
39,0,0,0,0,0,6,45,0
204,18,1,2,0,4,12,241,0
24,0,0,0,0,0,1,25,0
41,0,0,0,0,0,0,41,0
12,0,0,0,0,0,0,12,0
158,13,0,0,0,0,5,176,0
39,6,0,1,0,4,0,50,0
237,6,0,0,0,2,0,245,0
64,0,0,1,0,0,1,66,0
58,0,0,4,0,0,2,64,0
52,8,0,0,0,0,2,62,0
50,0,0,0,0,0,0,50,0
112,1,0,0,0,0,3,116,0
20,2,0,2,0,0,0,24,0
27,0,0,0,0,0,0,27,0
247,6,1,6,0,1,13,274,0
133,0,1,2,0,2,0,138,0
38,1,0,1,0,0,2,42,1
28,0,0,0,0,0,0,28,0
279,2,0,11,0,0,9,301,0
80,3,0,1,0,0,0,84,0
33,0,0,0,0,0,0,33,0
37,1,0,0,0,0,0,38,0
128,15,0,0,0,0,5,148,0
70,1,0,4,0,6,1,82,0
26,3,0,0,0,0,1,30,0
182,11,0,4,0,4,4,205,0
31,0,0,0,0,0,0,31,0
62,0,0,0,0,0,0,62,0
40,3,0,1,0,0,3,47,0
122,0,0,1,0,0,2,125,0
114,6,0,0,0,0,1,121,0
13,0,0,0,0,0,0,13,0
9,2,0,0,0,0,0,11,0
99,0,0,11,0,0,4,114,0
179,2,0,1,0,0,1,183,0
7,1,0,0,0,0,0,8,0
19,3,0,3,0,0,0,25,0
588,31,2,14,0,1,10,646,0
10,2,0,2,0,0,0,14,0
74,3,1,0,0,0,0,78,0
36,8,0,6,0,0,1,51,0
58,3,0,1,0,0,1,63,1
19,0,0,0,0,0,0,19,0
9,0,0,0,0,3,0,12,0
90,8,0,0,0,0,0,98,0
26,3,0,4,0,1,0,34,1
92,10,0,2,0,0,0,104,0
28,0,0,0,0,0,0,28,0
98,5,0,1,0,0,3,107,0
89,0,0,0,0,0,1,90,1
26,0,0,0,0,1,0,27,0
37,0,0,0,0,1,0,38,1
106,6,0,2,0,1,5,120,0
38,0,0,0,0,0,0,38,0
46,0,0,0,0,0,0,46,0
85,1,1,1,0,0,0,88,0
19,2,0,0,0,0,0,21,0
24,5,0,0,0,0,0,29,0
30,0,0,0,0,0,0,30,0
131,9,0,0,0,0,7,147,0
194,0,1,6,0,3,0,204,0
29,4,0,4,0,0,0,37,0
110,1,0,4,0,0,1,116,0
84,3,0,0,0,0,1,88,0
38,10,0,1,0,0,2,51,0
86,2,0,0,0,0,1,89,0
48,1,1,0,0,0,0,50,0
105,7,0,0,0,0,1,113,1
42,10,0,1,0,1,1,55,0
106,0,0,0,0,0,2,108,0
68,6,0,2,0,0,5,81,0
25,0,1,0,0,0,0,26,0
76,2,0,0,0,0,5,83,0
923,70,1,20,0,1,29,1044,0
23,0,0,1,0,0,0,24,0
82,3,0,0,0,0,1,86,0
61,1,0,0,0,0,0,62,0
13,1,0,0,0,0,0,14,0
12,0,0,4,0,0,0,16,0
72,0,0,1,0,0,2,75,0
76,1,0,0,0,0,0,77,0
11,0,0,0,0,0,0,11,0
8,4,0,0,0,0,1,13,0
9,4,0,0,0,0,1,14,0
52,1,0,0,0,0,0,53,0
250,32,1,3,0,0,17,303,0
8,0,0,1,0,0,0,9,0
64,3,1,0,0,1,6,75,0
16,0,0,0,0,0,0,16,0
39,10,0,4,0,4,4,61,0
49,22,0,1,0,0,5,77,0
3,0,0,0,0,0,0,3,0
197,22,1,0,0,0,1,221,0
114,13,0,0,0,0,0,127,0
63,9,0,4,0,0,0,76,0
127,62,2,8,0,5,4,208,0
23,7,0,0,0,0,1,31,0
41,12,0,2,0,0,6,61,0
12,0,0,0,0,1,0,13,0
64,7,0,0,0,0,0,71,0
113,8,0,2,0,0,6,129,0
59,0,0,2,0,0,2,63,0
40,0,0,1,0,0,0,41,0
44,2,1,0,0,0,0,47,0
131,0,0,0,0,3,0,134,0
44,3,0,0,0,0,6,53,0
67,3,1,0,0,0,0,71,0
9,0,0,0,0,0,0,9,0
62,11,0,11,0,1,4,89,0
28,0,0,1,0,0,2,31,0
110,6,0,18,0,0,0,134,0
52,0,0,0,0,0,0,52,0
24,0,0,0,0,0,0,24,0
44,4,0,0,0,0,0,48,0
0,1,0,0,0,0,0,1,0
34,0,0,0,0,0,1,35,0
50,4,0,7,0,0,0,61,0
29,5,0,7,0,0,1,42,0
47,2,0,1,0,0,0,50,0
23,7,0,0,0,0,1,31,0
31,1,0,0,0,0,3,35,0
34,0,0,0,0,0,0,34,0
38,2,0,0,0,0,0,40,0
59,7,0,0,0,0,1,67,1
18,0,0,0,0,1,0,19,0
19,1,0,1,0,0,0,21,1
151,34,0,1,0,1,8,195,0
92,31,0,1,0,0,1,125,0
14,3,0,0,0,0,0,17,0
133,16,0,2,0,0,0,151,0
232,17,0,9,0,13,11,282,0
57,1,0,8,0,0,7,73,0
58,3,0,0,0,0,1,62,0
60,7,0,0,0,0,1,68,1
42,8,0,0,0,0,0,50,0
58,0,0,1,0,5,4,68,0
55,0,3,1,0,0,5,64,0
4,4,0,0,0,0,0,8,0
60,9,0,0,0,1,3,73,0
109,16,0,0,0,0,6,131,0
41,9,1,0,0,0,0,51,0
201,68,0,1,0,3,26,299,1
212,40,1,6,0,3,19,281,1
285,75,4,4,0,13,18,399,0
34,16,0,2,0,0,2,54,0
55,24,1,1,0,0,0,81,0
38,5,0,5,0,0,5,53,0
34,3,0,0,0,0,0,37,0
70,31,0,2,0,14,9,126,0
49,16,4,0,0,0,5,74,0
70,11,4,2,0,2,3,92,0
36,3,0,0,0,0,4,43,0
97,25,0,10,0,1,13,146,0
19,6,0,0,0,0,0,25,0
58,22,0,0,0,2,3,85,0
33,3,0,4,0,0,1,41,0
65,21,0,2,0,0,2,90,0
677,119,3,31,0,10,54,894,0
12,3,0,0,0,0,0,15,0
27,0,0,1,0,0,0,28,0
18,5,0,0,0,0,0,23,0
25,21,0,9,0,0,0,55,0
63,11,0,9,0,1,0,84,0
100,22,1,15,0,0,1,139,1
38,12,0,0,0,0,2,52,0
66,6,0,0,0,0,5,77,0
119,24,0,7,0,0,7,157,0
57,13,0,3,0,2,0,75,0
53,23,1,13,0,6,1,97,1
22,16,0,3,0,0,3,44,0
3,3,0,0,0,0,1,7,0
5,2,0,0,1,0,0,8,0
25,22,0,4,0,6,2,59,0
25,2,0,0,0,0,0,27,0
20,25,0,1,0,0,3,49,1
8,1,0,0,0,0,0,9,0
63,53,0,31,0,9,2,158,0
2,3,0,1,0,1,0,7,0
4,3,0,1,0,0,0,8,0
5,0,0,1,0,0,1,7,1
13,30,0,1,0,6,3,53,0
14,7,0,1,0,1,0,23,0
6,10,0,1,0,0,0,17,0
5,6,0,0,0,1,0,12,1
296,181,0,12,0,0,13,502,0
65,6,0,1,0,0,0,72,0
39,48,0,0,0,1,6,94,0
91,2,0,1,0,0,5,99,0
32,53,0,3,0,1,0,89,0
30,10,1,0,0,0,4,45,1
31,22,0,0,0,0,5,58,0
310,70,2,6,0,4,15,407,0
132,20,0,0,0,0,0,152,0
92,21,0,9,0,0,3,125,0
64,21,0,4,0,5,4,98,0
119,4,0,2,0,2,2,129,0
27,0,0,4,0,0,0,31,0
26,0,0,0,0,0,0,26,0
32,0,0,0,0,0,0,32,0
73,0,0,2,0,1,1,77,0
87,0,0,1,0,0,0,88,0
39,0,0,0,0,0,0,39,0
174,3,6,6,0,0,2,191,0
94,18,0,3,0,0,7,122,0
16,8,0,0,1,0,0,25,0
28,0,1,0,0,0,2,31,0
5,0,0,0,0,0,0,5,0
3,0,0,0,0,0,0,3,0
17,0,0,0,0,0,0,17,0
59,57,0,12,0,2,0,130,0
61,6,0,0,0,0,2,69,0
16,0,0,0,0,2,0,18,0
7,1,1,2,0,0,0,11,1
8,0,0,0,0,0,0,8,0
14,0,0,0,0,0,0,14,0
4,1,0,0,0,0,0,5,0
9,0,0,0,0,0,0,9,0
79,41,0,3,0,0,9,132,0
60,14,0,1,0,0,3,78,0
27,5,0,0,0,0,0,32,0
19,15,0,0,0,1,3,38,0
41,7,0,3,0,0,0,51,0
3,156,0,0,0,0,0,159,0
185,172,0,1,0,0,7,365,0
66,28,0,0,0,0,2,96,0
7,41,0,0,0,0,0,48,0
142,35,0,5,0,6,8,196,0
86,13,0,6,0,1,0,106,0
7,0,0,0,0,5,1,13,0
3,0,0,0,0,0,0,3,0
510,289,5,31,0,44,41,920,0
60,10,0,0,0,1,0,71,0
41,40,0,6,0,3,15,105,0
22,11,0,0,0,2,0,35,0
105,0,0,1,0,0,3,109,0
61,0,0,0,0,0,0,61,0
6,0,0,0,0,0,0,6,0
35,0,0,4,0,0,0,39,0
18,0,0,0,0,0,0,18,0
105,7,0,9,0,3,4,128,0
81,4,0,11,0,0,7,103,0
27,0,0,0,0,0,0,27,0
10,0,0,1,0,0,2,13,0
29,1,0,1,0,0,1,32,1
21,0,0,0,0,0,0,21,0
15,0,0,0,0,0,0,15,0
37,5,0,0,0,0,0,42,0
59,0,0,0,0,0,0,59,0
30,0,0,0,0,0,0,30,0
4,0,0,0,0,0,0,4,0
263,16,0,39,0,0,11,329,0
89,14,0,26,0,1,3,133,0
76,0,0,21,0,0,0,97,0
67,10,0,12,0,0,1,90,0
31,6,0,13,0,0,4,54,0
41,0,0,0,4,1,0,46,0
16,0,0,2,0,0,0,18,0
14,0,0,0,0,0,0,14,0
142,7,0,2,0,0,4,155,0
14,0,0,0,0,0,0,14,0
112,0,0,0,0,0,0,112,0
27,12,0,1,0,0,1,41,2
68,0,0,12,0,1,2,83,0
37,0,0,4,0,0,0,41,0
113,3,0,22,0,0,0,138,0
57,5,0,12,0,0,0,74,0
70,0,0,31,0,0,2,103,0
39,3,0,8,0,0,3,53,0
26,6,0,0,0,1,0,33,0
22,0,0,0,0,0,0,22,0
68,4,1,0,0,0,0,73,0
40,0,0,8,0,0,0,48,0
2,0,0,0,0,0,0,2,0
10,0,0,1,0,0,2,13,0
23,0,0,1,0,0,0,24,0
30,0,0,8,0,0,7,45,0
35,0,0,0,0,0,0,35,0
2,0,0,0,0,0,0,2,0
10,0,0,0,0,0,1,11,0
37,0,0,0,0,0,0,37,0
24,0,0,0,0,0,0,24,0
5,0,0,0,0,0,0,5,0
17,0,0,0,0,0,0,17,0
80,4,0,0,0,0,9,93,0
27,0,1,0,0,0,0,28,0
59,1,0,0,0,0,0,60,0
157,0,0,0,0,0,6,163,0
123,0,0,0,0,0,0,123,0
0,0,0,5,0,0,0,5,0
53,2,0,6,0,0,3,64,0
4,0,0,0,0,0,0,4,0
7,0,0,0,0,0,0,7,0
15,0,0,0,0,0,0,15,0
172,14,0,8,0,3,10,207,0
68,4,0,1,0,0,0,73,0
26,0,0,1,0,0,0,27,0
46,0,0,2,0,0,2,50,0
19,1,0,0,0,0,1,21,1
20,0,0,0,0,0,1,21,0
23,2,0,1,0,0,0,26,0
358,33,0,15,0,7,11,424,0
35,0,0,1,0,0,0,36,0
28,0,0,0,0,0,0,28,0
31,4,0,0,0,0,0,35,0
28,1,0,0,0,0,6,35,0
7,0,0,0,0,0,0,7,0
26,0,0,0,0,0,0,26,0
49,4,0,1,0,1,0,55,0
11,0,0,0,0,0,0,11,0
29,1,0,4,0,0,0,34,0
12,0,0,3,0,0,0,15,0
6,0,0,4,0,0,0,10,0
45,10,0,1,0,4,0,60,0
31,3,0,0,0,0,0,34,0
106,7,0,2,0,0,2,117,0
20,0,0,0,0,0,0,20,0
18,0,0,4,0,0,0,22,0
23,0,1,0,0,0,0,24,0
138,6,0,22,0,1,5,172,0
28,3,0,1,0,0,0,32,0
20,4,0,3,0,0,0,27,0
164,17,0,1,0,0,5,187,0
21,4,0,2,0,2,0,29,0
52,0,0,2,0,0,0,54,0
1,0,0,1,0,0,0,2,0
6,0,0,0,0,0,0,6,0
2,0,0,0,0,0,0,2,0
3,2,0,0,0,0,0,5,0
8,0,0,0,0,0,0,8,0
0,3,0,0,0,0,0,3,0
7,0,0,0,0,0,0,7,0
3,0,0,0,0,0,0,3,0
6,0,0,0,0,0,0,6,0
25,0,0,1,0,0,0,26,1
18,0,0,2,0,0,0,20,0
2,0,0,0,0,0,0,2,0
18,0,0,0,0,0,0,18,0
15,0,0,1,0,0,2,18,0
14,1,0,0,0,0,0,15,0
79,4,0,0,0,3,4,90,0
8,0,0,0,0,0,1,9,0
0,2,0,0,0,0,0,2,0
2,0,0,0,0,0,0,2,0
7,1,0,0,0,0,1,9,0
4,0,0,0,0,0,0,4,0
16,3,0,0,0,0,0,19,0
170,25,0,3,0,2,3,203,0
47,0,0,2,0,0,1,50,0
37,2,0,0,0,0,0,39,0
69,3,0,1,0,2,1,76,0
38,0,0,3,1,0,2,44,0
7,0,0,0,0,0,0,7,0
23,1,0,0,0,0,0,24,0
16,7,0,0,0,0,0,23,0
16,4,0,0,0,0,0,20,0
43,3,0,0,0,0,1,47,0
68,5,0,1,0,0,1,75,1
14,5,0,0,0,0,2,21,0
12,0,0,0,0,0,0,12,0
71,8,0,1,0,0,0,80,0
14,6,0,2,0,0,0,22,0
70,6,1,3,0,2,3,85,0
21,2,0,0,0,0,0,23,0
36,4,0,0,0,0,0,40,0
28,0,0,4,0,0,0,32,0
38,1,0,0,0,4,0,43,0
17,5,0,0,0,1,0,23,0
50,8,0,1,0,0,1,60,0
73,20,0,4,0,0,3,100,0
13,5,0,0,0,0,0,18,0
25,8,0,2,0,0,0,35,0
68,6,0,4,0,0,2,80,0
52,1,0,1,0,0,2,56,0
18,0,0,0,0,0,1,19,0
39,2,0,0,0,0,1,42,1
20,0,0,0,0,0,0,20,0
11,0,0,2,0,0,0,13,0
5,0,0,0,0,0,0,5,0
21,4,0,0,0,0,0,25,0
21,5,0,1,0,0,4,31,0
3,0,0,0,0,0,0,3,0
7,0,0,0,0,0,0,7,0
2,0,0,0,0,0,0,2,0
73,5,0,2,0,3,6,89,0
32,7,0,1,0,0,0,40,0
54,10,0,0,0,0,0,64,0
14,0,0,0,0,0,0,14,0
72,12,0,0,0,0,0,84,0
31,2,0,1,0,0,1,35,0
28,11,0,3,0,0,0,42,0
32,0,0,0,0,0,0,32,0
65,4,0,0,0,0,0,69,0
64,4,0,0,0,1,1,70,0
14,0,0,0,0,0,0,14,0
28,1,0,1,0,0,0,30,0
10,5,0,0,0,0,0,15,0
15,5,0,0,0,0,0,20,0
0,2,0,0,0,0,0,2,0
10,1,0,0,0,0,0,11,1
4,0,0,0,0,0,0,4,0
24,0,0,0,0,0,0,24,0
5,0,0,0,0,0,0,5,0
52,5,0,4,0,1,0,62,0
3,0,0,0,0,0,2,5,0
15,0,0,0,0,0,0,15,0
81,1,0,1,0,4,2,89,1
63,8,0,0,0,0,2,73,0
10,8,0,0,0,0,0,18,0
4,0,0,0,0,0,0,4,0
2,0,0,0,0,0,0,2,0
17,0,0,0,0,0,0,17,0
9,4,0,0,0,0,0,13,0
13,1,0,0,0,0,0,14,0
182,21,2,10,0,3,19,237,0
36,8,0,3,0,0,1,48,1
22,5,0,0,0,0,0,27,0
14,2,0,0,0,0,0,16,0
28,3,0,1,0,0,0,32,1
19,8,0,0,0,0,1,28,0
1,0,0,12,0,0,2,15,0
3,0,0,0,0,0,0,3,0
15,6,0,4,0,0,0,25,0
32,14,0,0,0,0,0,46,0
13,3,0,0,0,0,0,16,0
13,0,0,0,0,0,0,13,0
40,3,0,1,0,0,0,44,0
40,0,0,1,0,0,1,42,0
0,0,0,0,0,0,1,1,0
23,0,0,0,0,0,0,23,0
9,0,0,0,0,0,0,9,0
6,0,0,0,0,0,0,6,0
7,0,0,0,0,0,0,7,0
8,1,0,3,0,0,0,12,0
127,10,0,7,0,3,5,152,0
0,0,0,0,0,0,1,1,0
55,0,0,0,0,0,0,55,0
4,0,0,0,0,0,3,7,0
7,0,0,1,0,0,1,9,0
0,6,0,0,0,0,0,6,0
9,0,0,0,0,0,0,9,0
2,0,0,0,0,1,0,3,0
82,0,0,0,0,0,1,83,0
10,0,0,0,0,0,0,10,0
5,1,0,0,0,0,1,7,0
52,0,0,3,0,0,0,55,0
208,29,0,24,0,0,7,268,0
133,42,0,15,0,0,8,198,0
58,10,0,0,0,0,6,74,0
14,0,0,1,0,0,0,15,1
2,0,0,0,0,0,0,2,0
7,0,0,0,0,0,0,7,0
1,0,0,0,0,0,0,1,0
24,2,0,3,0,0,0,29,0
125,11,0,3,0,2,4,145,0
8,0,0,0,0,0,0,8,0
20,2,0,0,0,0,0,22,0
27,2,0,2,0,0,4,35,0
89,15,0,3,0,0,2,109,0
10,0,0,7,0,0,1,18,0
4,0,0,0,0,0,1,5,0
4,0,0,0,0,0,0,4,0
11,6,0,0,0,0,0,17,0
8,0,0,0,0,0,0,8,0
66,13,0,3,0,1,2,85,0
5,0,0,0,0,0,0,5,0
36,7,0,1,0,0,5,49,0
66,6,0,7,0,5,3,87,0
6,0,0,0,0,0,0,6,0
35,3,0,1,0,0,4,43,0
31,3,0,0,0,1,0,35,1
12,0,0,0,0,3,0,15,0
93,10,1,2,0,0,0,106,0
13,7,0,2,0,0,0,22,0
35,2,0,0,0,0,0,37,0
106,9,1,1,0,0,1,118,0
108,9,0,3,0,1,1,122,1
73,0,0,7,0,1,0,81,0
27,2,0,2,0,0,0,31,0
38,4,0,0,0,0,0,42,0
42,2,0,0,0,0,0,44,0
10,3,0,0,0,0,0,13,0
72,6,0,2,0,0,3,83,0
35,0,0,0,0,0,0,35,0
15,0,0,1,0,0,0,16,0
3,0,0,0,0,0,0,3,0
8,1,0,0,0,0,0,9,0
20,1,0,0,0,0,0,21,1
1,0,0,0,0,0,0,1,0
30,6,1,0,0,0,0,37,1
6,0,0,0,0,0,0,6,0
16,1,0,4,0,0,0,21,0
80,7,0,0,0,3,0,90,0
87,11,0,7,1,2,2,110,0
17,3,0,0,0,0,0,20,0
105,25,0,11,0,3,1,145,0
33,0,0,0,0,0,0,33,0
67,6,0,4,0,0,1,78,0
22,4,0,6,0,0,0,32,0
29,1,0,0,0,0,0,30,0
41,8,0,4,0,0,0,53,0
204,9,0,3,0,0,1,217,1
15,0,0,3,0,0,0,18,0
173,20,0,6,0,4,3,206,0
23,4,0,5,0,0,1,33,0
19,0,0,10,0,0,1,30,0
7,6,0,1,0,0,0,14,0
13,9,0,8,0,0,0,30,0
13,2,0,0,0,0,0,15,0
26,9,0,1,0,0,0,36,0
62,22,0,7,0,0,3,94,0
10,0,0,2,0,0,0,12,0
11,3,0,0,0,0,0,14,0
50,10,0,1,0,0,0,61,0
32,1,0,1,0,0,0,34,1
32,0,0,1,0,0,0,33,0
47,12,0,1,0,0,3,63,0
23,0,0,0,0,0,0,23,0
1,1,0,0,0,0,0,2,1
12,11,0,5,0,0,0,28,0
13,1,0,1,0,0,1,16,0
19,0,0,0,0,1,0,20,0
20,9,0,2,0,0,3,34,0
31,1,0,0,0,0,0,32,0
35,8,0,0,0,0,2,45,0
32,6,0,0,1,0,0,39,0
68,11,0,1,0,1,2,83,0
81,11,0,0,0,0,5,97,0
26,2,0,0,0,0,1,29,0
71,12,0,14,0,0,0,97,0
23,2,0,0,0,0,0,25,0
18,3,0,0,0,0,0,21,0
126,5,0,3,0,0,4,138,0
48,0,0,6,0,0,1,55,0
61,7,5,7,0,0,1,81,0
54,16,0,10,0,0,4,84,0
30,10,0,3,0,0,4,47,0
2,0,0,0,0,0,0,2,0
4,2,0,0,0,0,0,6,0
36,4,1,0,0,0,0,41,0
67,5,0,8,0,1,3,84,0
61,6,0,18,0,0,3,88,0
11,1,0,13,0,0,0,25,0
45,1,0,27,0,0,1,74,1
640,52,1,137,0,0,21,851,0
28,0,0,1,0,0,2,31,0
22,0,0,19,0,0,0,41,0
40,0,0,5,0,0,0,45,0
31,0,0,2,0,0,0,33,0
12,0,0,0,0,0,1,13,0
23,8,0,19,0,0,0,50,0
26,4,0,4,0,0,0,34,0
71,0,0,25,0,0,3,99,0
394,35,0,59,0,0,2,490,0
39,5,0,0,0,0,0,44,0
53,0,0,4,1,0,2,60,0
39,3,0,4,0,0,0,46,0
51,17,0,27,0,0,2,97,0
18,4,0,4,0,0,0,26,0
46,1,0,7,0,2,1,57,1
5,1,0,0,0,0,0,6,1
76,11,0,15,0,0,0,102,0
13,0,0,14,0,0,1,28,0
29,0,0,7,0,5,0,41,0
67,1,0,18,0,0,2,88,1
120,7,0,53,0,3,8,191,0
24,0,0,16,0,0,0,40,0
26,0,0,0,0,0,1,27,0
38,3,0,22,0,0,1,64,0
30,4,0,8,0,0,0,42,0
49,4,0,21,0,0,4,78,0
3,0,0,0,0,0,0,3,0
2,0,0,0,0,0,0,2,0
6,0,0,0,0,0,0,6,0
11,2,0,0,0,0,0,13,0
40,3,0,2,0,0,0,45,0
7,0,0,0,0,0,0,7,0
34,0,0,0,0,0,0,34,0
3,0,0,1,0,0,0,4,0
9,0,0,1,0,0,0,10,0
27,0,0,4,0,0,2,33,0
6,0,0,0,0,0,0,6,0
0,2,0,0,0,0,0,2,0
70,0,0,9,0,0,0,79,0
15,0,0,1,0,0,1,17,0
2,0,0,0,0,0,0,2,0
41,1,0,0,0,0,2,44,0
30,0,0,2,0,0,0,32,0
12,0,0,0,0,1,0,13,0
8,1,0,1,0,0,5,15,0
9,0,0,0,0,0,0,9,0
3,0,0,0,0,0,0,3,0
193,3,0,7,0,0,2,205,0
29,5,0,1,0,0,0,35,0
35,0,0,0,0,0,0,35,0
11,0,0,0,0,0,0,11,0
72,0,0,0,0,0,0,72,0
3,0,0,0,0,0,0,3,0
12,1,0,4,0,0,0,17,0
89,6,0,12,0,0,0,107,0
30,6,0,0,0,0,8,44,0
31,0,0,0,0,0,3,34,0
24,0,0,5,0,0,2,31,0
30,0,0,5,0,0,3,38,0
29,0,0,1,0,0,4,34,0
5,0,0,1,0,0,0,6,0
57,4,0,0,0,0,0,61,0
13,0,0,0,0,0,0,13,0
56,8,0,9,0,0,2,75,0
14,2,0,5,0,0,0,21,0
47,1,0,10,0,0,0,58,0
201,3,0,19,0,0,15,238,0
31,0,0,6,0,0,0,37,0
48,0,0,13,0,0,2,63,0
10,0,0,0,0,0,0,10,0
6,0,0,0,0,0,0,6,0
65,4,0,8,0,0,4,81,0
12,3,0,0,0,0,0,15,0
107,16,0,4,0,0,5,132,0
75,11,0,5,0,0,0,91,0
85,0,0,19,0,0,3,107,0
35,0,0,4,0,0,0,39,0
31,0,0,4,0,0,0,35,0
51,0,0,1,0,1,0,53,0
42,3,0,5,0,1,1,52,1
25,3,0,5,0,0,0,33,0
112,7,0,13,0,0,4,136,0
89,0,0,9,0,0,0,98,0
43,0,0,1,0,0,2,46,1
53,0,0,6,0,0,0,59,0
4,0,0,0,0,0,0,4,0
72,7,0,5,3,0,1,88,0
19,4,0,0,0,0,0,23,0
29,3,1,0,0,0,0,33,0
3,0,0,3,0,0,0,6,0
38,0,0,12,0,0,0,50,0
381,38,0,11,0,2,4,436,0
42,0,0,0,0,0,3,45,0
16,0,0,1,0,0,3,20,1
26,0,0,2,0,3,0,31,0
21,0,0,5,0,0,3,29,0
33,0,0,7,0,0,3,43,0
31,0,0,4,0,0,0,35,0
6,0,0,0,0,0,0,6,0
23,0,0,0,0,0,0,23,0
4,0,0,0,0,0,0,4,0
10,0,0,4,1,0,0,15,0
39,0,0,0,0,0,1,40,0
25,1,0,0,0,0,2,28,0
197,5,0,8,0,0,2,212,0
78,1,0,13,0,1,0,93,1
31,0,0,0,0,0,0,31,0
117,4,0,1,0,0,3,125,0
28,0,0,0,0,0,0,28,0
73,0,0,5,0,0,0,78,0
34,0,0,4,0,0,2,40,0
104,0,4,1,0,0,4,113,0
47,0,0,3,0,0,0,50,0
5,0,0,0,0,0,0,5,0
1,0,0,0,0,0,2,3,0
1,0,0,0,0,0,0,1,0
36,3,0,8,0,0,0,47,0
2,3,0,3,0,0,0,8,0
3,0,0,4,0,0,0,7,0
374,7,0,22,0,5,4,412,0
20,0,0,0,0,0,0,20,0
2,0,0,0,0,0,0,2,0
27,0,0,0,0,0,0,27,0
24,0,0,0,0,0,0,24,0
53,4,0,0,0,0,0,57,0
14,0,0,0,0,0,0,14,0
374,9,0,26,0,0,6,415,0
33,1,0,0,0,0,0,34,0
27,0,0,0,0,5,0,32,0
27,0,0,6,0,0,0,33,0
21,3,0,0,0,0,1,25,0
317,24,0,19,0,0,6,366,0
27,0,0,5,0,0,1,33,0
189,9,0,0,0,0,3,201,0
4,0,0,0,0,0,0,4,0
192,2,0,8,0,0,4,206,0
55,0,0,0,0,0,0,55,0
38,0,0,4,0,0,0,42,0
4,0,0,0,0,0,0,4,0
382,16,0,19,1,6,6,430,0
4,0,0,0,0,0,0,4,0
2,0,0,0,0,1,0,3,0
141,0,0,9,0,1,4,155,0
5,0,0,0,0,0,0,5,0
8,0,0,0,0,0,0,8,0
478,6,0,25,1,8,7,525,0
22,0,0,0,0,0,0,22,0
10,0,0,0,0,0,0,10,0
1,0,0,4,0,0,0,5,0
4,0,0,0,0,0,0,4,0
27,0,0,0,0,0,0,27,0
1,2,0,0,0,0,0,3,1
73,0,0,0,0,0,7,80,0
94,2,0,9,1,0,1,107,1
38,9,0,2,0,0,0,49,0
25,0,0,0,0,0,0,25,0
12,0,0,0,0,0,0,12,0
19,1,0,0,0,0,2,22,0
10,0,0,0,0,0,0,10,0
26,0,0,0,0,0,0,26,0
18,0,0,0,0,0,0,18,0
9,0,0,0,0,0,0,9,0
11,0,0,0,0,0,0,11,0
24,8,0,5,0,0,0,37,0
20,0,0,8,0,0,0,28,0
14,0,0,0,0,0,0,14,0
5,0,0,0,0,0,0,5,0
12,0,0,2,0,0,0,14,0
117,8,0,0,0,0,0,125,0
6,0,0,0,0,0,0,6,0
28,0,0,6,0,0,0,34,0
22,0,0,2,0,0,0,24,0
6,2,0,0,0,0,0,8,0
38,0,0,0,0,0,0,38,0
12,0,0,0,0,0,0,12,0
3,0,0,0,0,0,0,3,0
17,4,0,0,0,0,0,21,0
1,0,0,0,0,0,1,2,0
1,5,0,0,0,0,0,6,0
0,0,0,2,0,0,0,2,0
46,2,0,0,0,0,0,48,0
156,28,0,1,0,0,3,188,0
26,13,0,1,0,0,0,40,0
193,16,0,5,0,0,1,215,1
124,6,0,5,0,0,2,137,0
80,0,0,2,0,0,0,82,0
27,14,0,5,0,0,2,48,0
71,18,0,4,0,0,7,100,0
241,47,0,8,0,0,5,301,0
25,12,0,3,0,0,1,41,0
53,6,0,5,0,0,0,64,0
1,0,0,0,0,0,0,1,1
75,4,0,0,0,0,0,79,0
35,0,0,0,0,0,2,37,0
229,23,0,10,0,0,3,265,0
31,4,1,18,0,6,3,63,0
40,6,0,0,0,0,0,46,0
23,4,0,0,0,0,0,27,0
81,3,0,0,0,0,0,84,0
42,0,0,5,0,0,4,51,0
223,28,2,13,0,0,8,274,0
57,6,0,2,0,0,0,65,0
171,6,0,2,0,0,0,179,0
8,2,0,2,0,0,0,12,0
23,0,0,0,0,0,0,23,0
117,25,0,21,0,0,1,164,0
62,7,0,6,0,0,0,75,0
39,0,0,4,0,0,0,43,0
86,4,0,9,0,0,1,100,1
177,17,0,6,0,0,0,200,0
19,1,0,0,0,0,0,20,1
8,0,0,0,0,2,0,10,0
18,0,0,2,0,0,0,20,0
7,0,0,0,0,0,0,7,0
146,6,0,7,0,0,0,159,0
60,3,0,6,0,0,0,69,0
101,4,0,0,0,1,3,109,0
246,21,0,10,0,0,6,283,0
91,1,0,2,0,4,0,98,0
197,22,0,0,0,0,8,227,0
74,3,0,0,0,0,0,77,0
133,23,0,3,0,0,2,161,0
55,6,0,0,0,0,2,63,0
23,2,0,0,0,0,0,25,0
56,2,0,0,0,0,0,58,0
65,1,0,0,0,0,0,66,0
41,3,0,0,0,0,0,44,0
14,0,0,0,0,0,0,14,0
945,139,1,56,0,22,37,1200,0
29,2,0,5,0,0,1,37,0
47,0,0,3,0,0,0,50,0
5,0,0,0,0,0,1,6,0
57,10,0,4,0,1,3,75,0
2,0,0,0,0,0,0,2,0
83,45,0,4,0,0,8,140,0
27,0,0,0,0,0,0,27,0
31,10,0,0,0,0,0,41,0
1,0,0,0,0,0,0,1,1
29,5,0,2,0,0,0,36,0
24,0,0,1,0,0,0,25,0
8,0,0,0,0,0,0,8,0
37,4,0,0,0,0,0,41,0
24,3,0,0,0,0,0,27,0
55,7,3,4,0,0,4,73,0
24,13,0,1,0,0,0,38,0
16,0,0,0,0,0,0,16,0
10,0,0,0,0,0,0,10,0
3,0,0,0,0,0,0,3,0
23,2,0,0,0,0,0,25,0
20,7,1,0,0,0,0,28,0
5,0,0,0,0,0,1,6,0
46,0,0,0,0,0,0,46,0
143,14,0,3,0,0,1,161,0
54,1,0,3,0,0,2,60,0
33,0,0,0,0,0,1,34,0
12,0,0,0,0,0,0,12,0
20,0,0,0,0,0,0,20,0
427,34,0,31,0,0,15,507,0
70,5,0,0,0,0,4,79,0
217,4,1,6,0,0,5,233,0
96,8,0,9,0,0,0,113,0
78,4,0,0,0,0,0,82,0
41,0,1,0,0,0,0,42,0
63,7,0,1,0,0,2,73,1
31,1,1,1,0,0,3,37,1
52,2,0,3,0,0,1,58,1
146,10,1,10,0,0,4,171,0
15,0,0,4,0,0,0,19,0
7,0,0,0,0,0,0,7,0
173,2,0,0,0,0,0,175,0
94,0,0,5,0,0,4,103,0
94,11,0,4,0,2,0,111,0
24,8,0,14,0,1,0,47,0
1,0,0,1,0,0,2,4,1
7,0,0,0,0,0,0,7,0
20,0,0,0,0,0,0,20,0
35,0,0,7,0,0,2,44,0
24,0,0,0,0,0,3,27,0
40,0,0,1,0,0,0,41,0
8,0,0,0,0,0,0,8,0
59,0,0,1,0,0,0,60,0
209,21,0,8,0,4,13,255,0
42,0,0,6,0,0,0,48,0
32,4,0,0,0,0,0,36,0
46,0,0,0,0,0,0,46,0
172,17,0,2,0,0,1,192,0
45,1,0,3,0,0,0,49,0
370,24,2,19,0,0,3,418,0
5,0,0,0,0,0,0,5,0
19,7,0,4,0,0,0,30,0
26,0,0,0,0,0,0,26,0
46,0,0,3,0,0,0,49,0
1,0,0,0,0,0,0,1,0
7,0,0,0,0,0,0,7,0
1,0,0,0,0,0,0,1,0
1,0,0,0,0,0,0,1,0
29,0,0,0,0,0,0,29,0
41,0,0,0,0,1,0,42,0
110,4,0,6,2,0,0,122,0
7,0,0,0,0,0,0,7,0
54,2,0,4,0,0,0,60,0
134,8,1,0,0,0,0,143,0
21,3,0,0,0,0,0,24,0
28,3,0,2,0,2,0,35,0
17,0,0,0,0,0,0,17,0
85,0,0,0,0,0,2,87,0
10,0,0,0,0,0,0,10,0
31,0,2,0,0,0,0,33,0
4,0,0,0,0,0,0,4,0
449,26,1,28,0,0,8,512,0
56,3,0,2,2,0,0,63,0
45,0,0,1,0,0,0,46,0
24,0,0,0,0,2,0,26,0
20,0,0,0,0,0,0,20,0
52,0,0,2,0,0,3,57,0
20,15,0,0,0,0,1,36,0
26,2,0,0,0,0,0,28,0
59,0,0,8,0,0,0,67,0
34,1,2,0,0,0,1,38,0
5,0,0,0,0,0,0,5,0
2,0,0,4,0,0,4,10,0
18,0,0,0,0,0,0,18,0
12,0,0,0,0,0,0,12,0
116,57,1,13,0,1,7,195,1
4,0,0,0,0,0,0,4,0
136,59,1,24,0,7,10,237,0
2,0,0,0,0,0,0,2,0
1,1,0,0,0,0,2,4,1
69,39,0,5,0,1,11,125,1
47,37,0,0,0,0,5,89,0
12,7,0,1,0,0,0,20,0
32,16,0,6,0,0,13,67,0
123,123,0,9,0,7,10,272,0
20,18,0,6,0,7,2,53,0
15,2,0,3,0,3,0,23,0
16,4,0,0,0,0,0,20,0
4,12,0,0,0,0,0,16,0
10,4,0,0,0,0,0,14,0
6,0,0,0,0,0,0,6,0
1,0,0,0,0,0,1,2,0
24,14,0,0,0,0,0,38,0
34,17,0,4,0,0,0,55,0
6,0,0,0,0,0,0,6,0
3,0,0,0,0,0,0,3,0
122,50,1,1,0,1,7,182,1
86,85,0,0,0,0,17,188,0
13,1,0,1,0,0,0,15,0
11,0,0,1,0,0,0,12,0
1,1,0,0,0,0,0,2,0
167,23,0,3,0,0,9,202,0
103,23,0,1,0,0,3,130,0
40,0,0,2,0,1,4,47,0
26,3,0,0,0,1,3,33,0
124,16,0,1,0,2,5,148,0
192,13,0,0,0,0,10,215,0
55,20,0,0,0,0,0,75,0
91,13,0,2,0,3,7,116,0
102,4,0,6,0,0,2,114,0
87,21,0,1,0,0,5,114,1
23,1,0,0,0,0,3,27,0
372,90,0,7,0,5,21,495,0
33,19,0,6,0,1,0,59,0
13,8,0,2,0,0,0,23,0
19,4,1,0,0,0,0,24,0
51,9,0,1,0,0,5,66,0
54,15,0,0,0,2,0,71,0
71,18,0,2,0,7,6,104,0
14,2,0,0,0,2,0,18,0
32,10,0,0,0,0,0,42,0
88,15,0,1,0,0,2,106,0
99,37,0,4,0,4,1,145,0
78,7,0,4,0,2,1,92,1
97,18,0,5,0,0,7,127,0
46,17,0,0,0,0,1,64,0
74,12,0,4,0,0,0,90,0
46,14,0,0,0,0,7,67,0
110,25,0,6,0,4,7,152,0
30,5,0,2,0,0,0,37,0
0,1,0,0,0,0,0,1,0
51,23,0,2,0,1,0,77,0
56,16,0,7,0,0,1,80,0
33,11,0,0,0,0,0,44,0
78,22,2,8,0,0,0,110,0
27,11,0,0,0,0,1,39,1
45,15,0,5,0,0,1,66,0
50,3,0,0,0,0,0,53,0
27,10,0,0,0,0,0,37,0
35,7,0,0,0,0,3,45,0
71,36,0,0,0,0,5,112,0
24,21,0,2,0,0,2,49,0
30,16,0,2,0,1,2,51,0
33,8,0,2,0,0,8,51,0
52,19,0,0,0,0,0,71,0
34,19,0,1,0,0,5,59,0
38,18,0,1,0,2,0,59,0
29,23,0,1,0,3,3,59,1
22,8,0,0,0,0,2,32,0
99,8,0,0,0,0,4,111,0
94,92,0,8,0,1,18,213,0
0,2,0,0,0,0,0,2,0
18,41,0,3,0,0,5,67,0
11,20,0,0,1,0,0,32,0
5,0,0,0,0,0,0,5,0
12,2,0,0,0,0,0,14,0
42,97,0,1,0,0,0,140,0
29,120,0,13,0,5,11,178,0
24,36,0,2,0,2,3,67,0
6,27,1,0,0,0,1,35,0
2,0,0,0,0,0,0,2,0
16,63,0,0,0,0,11,90,0
1,0,0,0,0,0,0,1,0
3,0,0,0,0,0,0,3,0
313,112,1,6,0,8,13,453,0
21,2,0,0,0,1,0,24,1
71,17,0,3,0,0,0,91,0
9,0,0,0,0,0,0,9,0
7,5,0,0,0,1,0,13,0
3,0,0,0,0,0,0,3,0
226,63,0,27,0,8,10,334,0
42,21,0,0,0,0,0,63,0
88,22,0,7,0,1,2,120,0
40,23,0,8,0,0,5,76,0
1,2,0,0,0,0,0,3,0
31,10,0,0,0,0,0,41,0
61,31,0,1,0,1,0,94,0
158,66,1,6,0,2,10,243,0
52,20,0,1,0,0,8,81,0
55,9,1,0,0,0,2,67,0
56,11,0,5,0,1,0,73,0
77,61,0,3,0,0,0,141,0
99,29,0,7,0,2,9,146,0
3,0,0,0,0,0,0,3,0
3,0,0,0,0,0,0,3,0
86,32,1,0,0,0,0,119,0
36,24,0,3,0,0,4,67,0
0,5,0,0,0,0,0,5,0
27,45,0,0,0,1,3,76,0
5,23,0,0,0,0,0,28,0
67,18,0,0,0,0,4,89,0
231,73,2,2,0,2,12,322,0
80,24,0,0,0,0,0,104,0
81,39,0,12,0,1,0,133,1
77,20,1,0,0,0,2,100,1
140,40,0,1,0,3,2,186,0
81,21,0,0,0,0,2,104,0
16,2,0,0,0,0,0,18,0
98,38,0,1,0,1,1,139,1
28,19,0,0,0,0,8,55,0
2,0,0,0,0,0,0,2,0
42,7,0,0,0,0,0,49,0
14,44,0,0,0,2,0,60,0
2,2,0,0,0,3,0,7,0
18,16,0,1,0,5,1,41,1
3,11,0,0,0,0,0,14,0
3,0,0,0,0,0,0,3,0
171,173,1,12,0,14,19,390,0
107,106,1,5,0,17,5,241,0
24,12,2,0,0,6,5,49,0
20,25,0,0,0,1,0,46,0
19,3,1,0,0,1,1,25,0
3,0,1,0,0,0,0,4,0
2,0,0,0,0,0,0,2,0
1,6,0,0,0,0,1,8,0
2,0,0,0,0,0,0,2,0
20,0,0,0,0,0,0,20,0
2,0,0,0,0,0,0,2,0
11,0,0,0,0,0,0,11,0
108,14,0,0,0,0,1,123,1
327,12,0,12,0,0,6,357,0
33,0,0,0,0,0,0,33,0
17,2,0,0,0,0,0,19,0
25,0,1,0,0,0,0,26,0
24,2,0,0,0,0,1,27,0
165,13,0,0,0,2,0,180,0
21,9,0,0,0,0,3,33,0
23,0,0,0,0,0,0,23,0
4,0,0,0,0,0,0,4,0
49,15,0,4,0,2,0,70,0
16,7,1,4,0,0,3,31,1
33,7,0,0,0,1,2,43,0
20,19,0,0,0,0,0,39,0
34,20,0,9,0,2,2,67,0
42,13,0,7,0,2,0,64,0
43,0,0,0,0,1,0,44,0
191,67,1,5,0,3,5,272,0
93,41,0,0,0,0,5,139,0
31,0,0,0,0,0,0,31,0
27,0,0,0,0,0,0,27,0
224,65,0,8,0,1,8,306,0
32,4,0,4,0,0,0,40,0
43,9,0,3,0,2,0,57,0
38,2,0,0,0,0,3,43,0
41,11,0,0,0,0,1,53,0
23,8,0,0,0,2,3,36,0
9,0,0,0,0,0,0,9,0
24,3,0,0,0,0,0,27,0
39,22,0,0,0,1,3,65,0
47,8,0,0,0,0,3,58,0
36,2,0,0,0,1,0,39,0
13,0,0,0,0,0,0,13,0
22,0,0,3,0,0,0,25,0
4,0,0,0,0,0,0,4,0
25,3,0,0,0,0,2,30,0
354,115,1,29,0,2,29,530,0
39,30,0,5,0,0,3,77,0
151,45,0,0,0,0,11,207,0
18,12,0,1,0,0,0,31,0
40,15,0,2,0,0,2,59,0
8,1,0,0,0,0,1,10,0
40,15,0,0,0,0,0,55,0
60,23,4,1,0,0,3,91,0
32,7,0,0,0,0,2,41,0
33,19,0,3,0,0,0,55,0
58,9,0,0,0,0,4,71,0
21,8,0,0,0,0,0,29,0
22,9,0,0,0,0,0,31,0
51,12,1,8,0,2,9,83,0
35,3,0,0,0,0,3,41,0
68,21,0,0,0,0,4,93,0
52,33,0,0,0,0,0,85,0
20,8,0,0,0,0,0,28,0
66,24,0,2,0,1,1,94,0
45,14,0,0,0,0,0,59,0
155,32,1,0,0,2,4,194,0
58,10,0,2,0,0,0,70,0
25,2,0,0,0,0,0,27,0
101,20,0,1,0,0,1,123,0
37,13,0,0,0,4,0,54,0
19,10,0,0,0,0,1,30,0
73,13,0,1,0,0,3,90,0
49,14,0,0,0,0,4,67,0
25,8,0,1,0,0,2,36,0
18,0,0,0,0,0,0,18,0
47,29,0,3,0,4,3,86,0
15,25,0,4,0,0,4,48,0
33,21,0,0,0,0,4,58,0
6,0,0,0,0,0,0,6,0
1,0,0,0,0,0,0,1,1
101,19,0,5,0,6,2,133,0
95,22,0,0,0,0,0,117,0
40,11,0,0,0,0,2,53,0
380,126,0,10,0,7,22,545,0
10,4,0,0,0,0,0,14,0
16,15,0,0,0,0,4,35,0
67,23,0,3,0,0,0,93,0
55,28,0,0,0,0,1,84,0
25,0,0,0,0,0,6,31,0
24,11,0,1,0,0,0,36,0
153,141,0,0,0,6,6,306,0
21,15,0,0,0,0,0,36,0
25,7,0,1,0,0,0,33,1
134,79,0,2,0,8,6,229,0
25,9,0,0,0,0,0,34,0
54,9,0,1,0,2,1,67,0
34,5,0,1,0,2,3,45,0
34,7,0,0,0,0,0,41,0
40,10,0,0,0,0,7,57,0
63,345,1,4,0,0,9,422,0
45,253,0,6,0,5,4,313,0
0,40,0,0,0,0,0,40,0
11,45,0,1,0,0,2,59,0
2,0,0,0,0,0,0,2,0
56,31,1,0,0,0,6,94,0
15,4,0,0,0,0,0,19,0
5,2,0,3,0,0,0,10,0
23,2,0,0,0,0,0,25,0
17,0,0,0,0,1,0,18,0
12,10,0,2,0,0,0,24,0
13,26,0,0,0,0,0,39,0
40,14,0,4,0,0,0,58,0
12,1,0,0,0,1,0,14,0
1,0,0,0,0,0,0,1,0
66,8,0,3,0,0,0,77,0
95,0,0,0,0,2,6,103,0
665,95,0,37,0,0,12,809,0
93,20,0,2,0,0,0,115,0
10,0,0,0,0,0,3,13,0
21,2,0,0,0,0,0,23,0
33,6,0,0,0,0,0,39,0
30,17,0,9,0,0,0,56,0
227,19,0,16,0,0,5,267,0
1,0,0,0,0,0,0,1,0
68,82,0,17,0,10,6,183,0
11,24,0,12,0,0,0,47,0
15,8,0,2,0,0,0,25,0
0,9,0,1,0,0,0,10,0
28,33,0,23,0,0,8,92,0
12,7,0,0,0,3,0,22,0
64,46,0,18,0,4,5,137,0
9,7,0,9,0,2,0,27,0
7,22,0,2,0,0,5,36,0
6,2,0,11,0,0,0,19,0
20,0,0,0,0,0,0,20,0
11,0,0,0,0,0,0,11,0
74,3,0,1,0,0,0,78,0
18,0,0,0,0,0,0,18,0
30,2,0,0,0,1,0,33,0
17,0,2,0,0,6,0,25,0
32,9,0,0,0,0,0,41,0
21,2,2,0,0,0,0,25,0
9,0,0,0,0,0,0,9,0
7,0,0,0,0,0,0,7,0
3,0,0,0,0,0,0,3,0
5,0,0,0,0,0,0,5,0
1,0,0,0,0,0,0,1,0
38,11,0,2,0,0,0,51,0
221,54,0,3,0,16,22,316,0
106,12,2,3,0,2,4,129,0
47,28,0,3,0,18,5,101,0
87,14,0,1,0,0,1,103,0
126,6,0,2,0,9,0,143,0
150,37,1,7,0,9,15,219,1
33,1,0,0,0,2,1,37,0
135,6,0,2,0,1,2,146,0
94,11,0,1,0,0,4,110,0
118,9,2,5,0,0,10,144,0
82,8,0,1,0,1,0,92,0
165,4,0,1,1,0,0,171,0
136,11,0,0,0,0,4,151,0
53,0,0,0,0,0,0,53,0
140,2,0,4,0,7,1,154,0
119,5,1,0,0,5,10,140,0
59,19,0,1,0,1,2,82,0
118,10,0,1,0,1,1,131,0
83,11,0,0,0,0,3,97,0
73,6,0,0,0,0,0,79,0
76,7,1,1,0,6,3,94,1
83,12,0,0,0,0,5,100,0
120,5,0,1,0,0,1,127,1
82,0,0,0,0,0,4,86,0
45,0,0,0,0,3,3,51,0
54,6,0,12,0,0,0,72,0
67,6,0,0,0,0,6,79,0
45,7,0,0,0,0,3,55,0
154,8,0,10,0,8,10,190,0
116,11,0,3,0,0,0,130,0
92,16,0,4,0,1,3,116,0
74,4,0,6,0,0,0,84,0
50,1,0,2,0,0,0,53,0
250,68,0,2,0,0,6,326,0
57,92,1,1,0,0,9,160,0
8,15,0,0,0,0,3,26,0
0,6,3,0,0,0,1,10,1
124,18,0,0,0,0,1,143,1
33,8,0,0,0,1,3,45,0
46,0,0,0,0,0,0,46,0
116,10,0,6,0,0,1,133,0
49,5,0,0,0,0,0,54,0
45,4,0,5,0,0,0,54,0
50,1,0,0,0,0,1,52,0
29,0,0,0,0,0,1,30,0
155,0,0,5,0,0,7,167,0
42,0,0,0,0,0,3,45,0
64,2,0,0,0,0,0,66,0
20,7,0,1,0,0,1,29,0
38,0,0,0,0,0,3,41,0
21,3,0,0,0,0,0,24,0
42,1,1,3,0,0,0,47,1
46,5,0,0,0,0,1,52,0
23,0,0,0,0,0,0,23,0
1,0,0,0,0,0,1,2,0
160,13,3,7,0,11,13,207,0
185,78,0,3,0,9,7,282,0
17,1,0,0,0,0,1,19,1
18,2,0,2,0,0,0,22,0
140,7,0,0,0,6,1,154,0
55,0,1,0,0,0,2,58,0
34,3,0,0,0,0,1,38,0
41,8,0,2,0,1,6,58,0
17,0,3,0,0,0,0,20,0
74,6,0,3,0,0,0,83,0
46,0,0,0,0,0,0,46,0
112,5,0,0,0,0,0,117,0
42,8,0,1,0,0,3,54,0
30,10,0,0,0,0,0,40,0
142,21,0,2,0,8,7,180,0
47,6,0,0,0,0,2,55,0
66,15,0,0,0,5,2,88,0
21,4,0,0,0,0,0,25,0
89,17,0,1,0,0,0,107,1
22,0,0,0,0,0,0,22,0
25,0,0,0,0,0,0,25,0
94,6,0,0,0,0,5,105,0
77,10,0,0,0,0,2,89,0
63,34,0,0,0,2,9,108,0
149,3,0,0,0,0,6,158,0
56,0,0,0,0,0,0,56,0
8,0,0,0,0,0,0,8,0
17,0,0,0,0,0,0,17,0
1,0,0,0,0,0,0,1,0
9,0,0,0,0,0,4,13,0
21,3,0,0,0,0,0,24,0
11,0,0,0,0,0,0,11,0
126,2,0,1,0,0,1,130,0
100,40,0,1,0,16,9,166,0
36,0,0,0,0,0,0,36,0
4,0,0,0,0,0,0,4,0
10,0,0,0,0,0,0,10,0
0,1,0,0,0,0,0,1,0
2,0,0,0,0,0,0,2,0
1,0,0,0,0,0,0,1,0
3,0,0,0,0,0,2,5,0
21,2,0,0,0,0,1,24,0
168,1,0,0,0,0,2,171,0
73,6,0,7,0,0,0,86,0
23,0,0,4,0,0,1,28,0
33,1,0,0,0,0,0,34,1
42,0,0,0,0,0,1,43,0
44,0,0,1,0,0,0,45,1
79,2,0,0,0,0,3,84,0
73,0,0,0,0,0,2,75,0
58,1,3,2,0,5,0,69,0
41,7,0,0,0,0,5,53,0
74,7,1,0,1,0,1,84,0
79,7,0,6,0,0,4,96,0
29,0,0,0,0,0,0,29,0
35,5,0,0,0,0,0,40,0
13,0,0,3,0,0,0,16,0
42,3,0,0,0,3,3,51,0
22,0,0,0,0,0,0,22,0
51,7,0,0,0,0,1,59,0
29,2,0,0,0,0,2,33,0
7,0,0,0,0,0,0,7,0
18,0,0,0,0,0,1,19,0
10,0,0,1,0,0,2,13,0
11,0,0,0,0,0,0,11,0
3,0,0,0,0,0,0,3,0
221,19,0,5,0,0,2,247,0
38,1,0,4,0,0,2,45,0
3,0,0,0,0,2,0,5,0
23,0,0,2,0,0,0,25,0
11,0,0,0,0,0,0,11,0
13,5,0,0,0,0,0,18,0
88,7,1,2,0,6,2,106,0
232,5,0,0,0,0,2,239,0
48,0,0,0,0,0,0,48,0
79,7,0,0,0,0,0,86,0
0,1,0,1,0,0,1,3,0
46,9,0,0,0,0,4,59,0
38,0,0,0,0,0,0,38,0
53,0,0,0,0,0,2,55,0
49,12,0,6,0,1,0,68,0
52,3,0,0,0,0,0,55,0
167,44,1,6,0,7,6,231,1
210,56,3,22,0,0,8,299,0
40,3,0,0,0,0,1,44,0
54,6,0,0,0,0,3,63,0
300,155,0,7,0,2,7,471,0
32,0,0,0,0,0,0,32,0
56,8,0,1,0,0,0,65,0
16,4,0,0,0,0,4,24,0
51,4,0,0,0,0,0,55,0
130,13,0,0,0,3,11,157,0
16,7,0,0,0,0,0,23,0
21,10,0,0,0,3,6,40,0
32,28,0,7,0,0,4,71,0
197,23,0,4,0,0,6,230,0
27,5,0,1,0,0,2,35,0
21,9,0,9,0,0,5,44,0
34,11,0,0,0,0,0,45,0
8,3,0,0,0,0,0,11,0
2,0,0,0,0,0,0,2,0
77,16,0,12,0,0,0,105,0
37,11,0,0,0,0,0,48,0
88,40,1,0,0,1,3,133,0
144,12,0,6,0,0,8,170,0
40,6,0,0,0,0,6,52,0
5,1,0,0,0,0,0,6,0
39,26,0,10,0,0,3,78,0
93,16,0,3,0,0,6,118,0
31,10,0,0,0,0,2,43,0
62,28,0,0,0,0,0,90,0
12,6,0,5,0,0,0,23,0
96,8,2,14,0,0,0,120,0
20,9,0,1,0,0,0,30,0
84,2,0,7,0,0,3,96,0
35,5,0,0,0,0,0,40,0
44,8,0,2,0,13,0,67,0
3,0,0,0,0,0,0,3,0
80,0,0,2,0,0,0,82,0
80,16,0,0,0,0,0,96,0
181,24,0,3,0,3,3,214,0
104,12,0,7,0,0,0,123,0
61,6,0,2,0,0,3,72,0
137,22,0,1,0,2,5,167,0
172,23,0,0,0,1,2,198,0
51,9,0,7,0,0,1,68,1
14,1,0,0,0,0,0,15,0
1,0,0,0,0,0,0,1,0
5,0,0,0,0,0,0,5,0
2,0,0,0,0,0,0,2,0
17,0,0,0,0,0,0,17,0
72,4,0,2,0,0,2,80,0
15,3,0,0,0,0,0,18,0
61,12,0,0,0,0,1,74,0
243,11,1,6,0,5,14,280,0
44,2,0,0,0,0,3,49,0
57,5,0,0,0,0,0,62,0
274,116,2,19,0,4,34,449,0
15,1,0,0,0,0,0,16,0
170,13,0,0,0,1,3,187,0
66,15,0,1,0,0,3,85,0
26,2,0,0,0,0,1,29,0
216,37,0,11,0,0,2,266,0
29,6,0,0,0,0,0,35,0
46,4,0,3,0,0,0,53,0
34,13,0,0,0,0,0,47,0
0,0,0,6,0,0,0,6,0
211,24,0,11,0,0,7,253,0
16,0,0,0,0,0,0,16,0
191,12,0,0,0,0,6,209,0
51,0,0,0,0,0,0,51,0
46,3,0,0,0,0,0,49,0
38,7,0,6,0,0,0,51,0
41,14,0,0,0,0,0,55,0
31,5,0,0,0,0,0,36,0
64,5,0,1,0,1,0,71,0
85,9,0,7,0,0,0,101,0
116,19,0,3,0,6,5,149,0
87,16,0,2,0,1,5,111,0
67,10,3,0,0,4,0,84,0
112,6,0,7,0,0,10,135,0
101,0,0,0,0,11,8,120,0
432,53,4,39,1,10,10,549,0
2,0,0,0,0,0,0,2,0
70,10,0,1,0,0,1,82,1
89,3,0,4,0,0,4,100,0
32,11,0,3,0,3,1,50,1
23,0,0,0,0,0,0,23,0
417,26,0,34,2,5,8,492,0
101,3,0,2,0,1,4,111,1
80,26,0,9,0,0,4,119,0
34,6,0,0,0,0,0,40,0
215,23,0,11,0,0,0,249,0
25,3,0,0,0,0,1,29,0
79,10,0,9,0,0,1,99,0
61,11,0,2,0,0,0,74,0
36,2,0,12,0,0,0,50,0
48,19,0,7,0,3,0,77,0
20,9,0,0,0,0,0,29,0
14,0,0,0,0,0,0,14,0
24,9,0,0,0,0,0,33,0
290,57,2,19,0,2,8,378,0
14,14,0,3,0,0,3,34,0
23,8,0,3,0,0,2,36,0
25,14,0,10,0,0,0,49,0
82,22,0,29,0,0,4,137,0
64,10,0,0,0,0,4,78,0
87,10,0,1,0,0,9,107,0
50,0,0,0,0,0,0,50,0
750,162,2,44,2,6,32,998,0
103,0,0,0,0,0,2,105,0
385,186,0,3,0,5,39,618,0
64,15,2,5,0,1,4,91,0
81,4,0,0,0,0,2,87,0
58,6,0,5,0,1,0,70,0
37,0,0,3,0,0,0,40,0
56,11,0,3,0,0,3,73,0
132,34,0,0,0,0,0,166,0
19,6,0,0,0,0,1,26,0
59,10,0,0,0,0,0,69,0
47,12,0,0,0,0,0,59,0
74,4,0,0,0,1,3,82,0
186,25,0,7,0,0,0,218,0
59,11,0,0,0,0,0,70,0
67,5,0,0,0,0,0,72,0
211,30,1,6,0,6,4,258,0
154,66,1,10,0,7,10,248,0
38,24,0,8,0,3,0,73,0
32,1,0,2,0,0,0,35,0
219,17,5,3,0,1,4,249,0
279,42,0,2,0,1,10,334,0
25,0,0,4,0,0,0,29,0
24,6,0,0,0,0,0,30,0
44,0,0,0,0,0,0,44,0
84,9,0,5,0,5,0,103,0
57,21,0,5,0,1,0,84,0
126,20,0,2,0,0,0,148,0
123,19,0,2,1,0,4,149,0
86,12,1,1,0,0,2,102,1
120,35,0,2,0,0,6,163,0
47,0,0,0,0,0,0,47,0
43,9,0,0,0,0,0,52,0
128,20,0,3,0,0,0,151,0
45,11,0,3,0,0,4,63,0
94,13,0,18,0,0,3,128,0
78,15,0,13,4,0,0,110,0
16,6,0,0,0,0,5,27,0
103,613,1,8,0,7,40,772,0
8,1,0,0,0,0,0,9,0
0,14,0,0,0,0,0,14,0
0,10,0,0,0,0,0,10,0
1,84,0,0,0,0,1,86,0
0,23,0,0,0,0,0,23,0
0,14,0,0,0,0,0,14,0
0,73,2,0,0,0,1,76,0
0,35,0,0,0,0,3,38,0
4,43,0,0,0,0,2,49,0
8,117,0,0,0,0,12,137,0
0,29,0,0,0,0,5,34,0
0,44,0,0,0,0,0,44,0
3,63,0,0,0,0,5,71,0
2,32,0,0,0,0,0,34,0
0,53,0,0,0,0,0,53,0
5,94,1,0,0,0,7,107,0
1,86,0,0,0,0,0,87,0
0,34,0,0,0,0,0,34,0
11,119,0,0,0,0,2,132,0
4,76,0,0,0,2,5,87,0
1,63,2,0,0,0,0,66,0
2,39,0,0,0,0,0,41,0
11,101,0,0,0,1,1,114,1
10,135,1,0,0,2,8,156,0
14,113,3,0,0,2,3,135,0
0,107,0,1,0,0,2,110,0
0,70,0,0,0,0,0,70,0
11,56,0,0,0,0,3,70,0
14,82,1,0,0,1,1,99,1
62,307,0,4,0,5,9,387,0
4,88,0,0,0,0,1,93,0
27,47,0,0,0,0,4,78,0
9,44,0,0,0,0,2,55,0
25,61,0,1,0,1,1,89,1
0,47,0,0,0,0,0,47,0
30,30,0,0,0,7,0,67,0
15,68,0,0,0,0,0,83,0
0,144,0,0,0,0,3,147,0
1,33,0,0,0,0,0,34,0
1,20,0,0,0,0,0,21,0
3,142,0,0,0,0,2,147,0
14,338,1,0,0,0,22,375,0
4,112,0,0,0,1,0,117,0
6,51,0,0,0,1,12,70,1
9,38,2,0,0,0,4,53,0
7,73,0,2,0,8,5,95,0
3,43,0,0,0,0,2,48,0
10,115,0,0,0,3,0,128,0
6,38,0,0,0,0,0,44,0
3,59,0,3,0,0,0,65,0
14,104,0,0,0,0,6,124,0
0,97,0,0,0,0,6,103,0
10,77,0,0,0,0,5,92,0
5,67,3,0,0,0,4,79,0
4,141,0,0,0,0,14,159,0
0,72,1,0,0,0,1,74,0
0,42,0,0,0,0,1,43,0
11,74,0,0,0,4,10,99,0
0,20,0,0,0,0,0,20,0
3,66,0,0,0,0,0,69,0
52,224,0,0,0,0,7,283,0
6,24,0,0,0,0,3,33,0
19,356,0,0,0,4,29,408,0
0,2,0,0,0,0,0,2,0
13,16,6,1,0,0,0,36,0
62,66,0,0,0,2,10,140,0
9,10,0,0,0,0,0,19,0
1,0,0,0,0,0,0,1,0
5,202,1,0,0,0,9,217,0
19,19,0,0,0,0,0,38,0
49,46,0,0,0,4,0,99,0
59,36,1,0,0,1,1,98,0
13,7,5,0,0,0,0,25,0
19,16,7,0,0,6,0,48,0
43,49,0,0,0,1,4,97,1
0,8,0,0,0,0,0,8,0
0,23,0,0,0,0,0,23,0
0,0,0,0,0,1,2,3,0
55,39,0,0,0,13,0,107,0
21,84,0,0,0,0,1,106,0
14,75,0,0,0,0,3,92,0
3,92,0,0,0,0,2,97,0
12,62,0,0,0,0,0,74,0
10,69,0,5,0,1,0,85,0
4,29,0,0,0,0,0,33,0
8,18,0,0,0,0,0,26,0
16,24,0,0,0,0,0,40,0
28,24,0,0,0,0,3,55,0
7,43,0,0,0,0,0,50,0
19,76,0,0,0,2,2,99,0
27,67,3,0,0,3,0,100,0
10,42,0,0,0,0,1,53,1
5,12,0,0,0,0,0,17,0
14,63,0,0,0,0,0,77,0
3,47,0,0,0,0,1,51,0
11,177,1,0,0,5,5,199,0
19,12,0,0,0,3,0,34,0
5,11,0,0,0,0,0,16,0
8,9,2,0,0,0,2,21,0
6,21,0,0,0,0,0,27,0
27,12,0,0,0,0,3,42,0
35,14,0,0,0,0,3,52,0
11,10,0,0,0,0,3,24,0
1,1,0,0,0,0,1,3,1
7,44,0,0,0,0,1,52,0
2,69,0,0,0,0,0,71,0
2,21,1,0,0,0,0,24,0
7,8,0,0,0,0,1,16,0
38,0,0,0,0,0,0,38,0
87,317,0,9,0,25,9,447,0
46,19,0,0,0,2,0,67,0
27,27,0,0,0,3,0,57,0
49,18,0,0,0,0,0,67,0
54,20,0,2,0,3,3,82,0
38,55,0,1,0,6,0,100,0
65,22,0,7,0,0,11,105,0
73,48,0,2,0,0,2,125,0
39,0,0,2,0,0,0,41,0
97,1,2,0,0,103,10,213,0
2,2,0,0,0,0,0,4,0
2,0,0,0,0,0,0,2,0
3,0,0,0,0,0,0,3,0
6,0,0,0,0,0,0,6,0
1,0,0,0,0,0,0,1,1
0,1,0,0,0,0,1,2,0
6,0,0,0,0,0,0,6,0
23,16,0,3,0,4,0,46,0
34,46,0,6,0,0,2,88,0
4,3,0,1,0,0,1,9,0
89,484,9,20,0,68,41,711,0
45,58,0,1,0,0,21,125,0
13,21,0,0,0,1,0,35,0
22,88,0,0,0,2,4,116,0
5,0,0,0,0,0,0,5,0
40,162,0,3,0,1,26,232,0
23,66,1,6,0,2,5,103,0
46,260,0,0,0,43,20,369,0
12,70,0,0,0,11,2,95,0
5,44,0,0,0,0,0,49,0
89,745,4,8,0,62,32,940,0
22,106,0,0,0,4,6,138,0
13,115,0,0,0,16,5,149,0
79,93,1,0,0,17,2,192,1
24,1,0,0,0,8,5,38,0
4,12,0,0,0,2,1,19,0
54,332,3,0,0,22,7,418,0
15,161,0,8,0,0,5,189,0
4,24,0,0,0,0,3,31,0
4,67,0,0,0,1,0,72,0
2,76,0,0,0,0,0,78,0
3,36,0,0,0,0,3,42,0
16,94,0,7,0,0,11,128,0
49,277,0,1,0,17,14,358,0
0,4,0,0,0,0,0,4,0
1,14,0,5,0,0,0,20,0
3,18,0,0,0,0,0,21,0
29,194,0,20,0,0,0,243,0
70,29,0,0,0,1,0,100,0
4,351,0,6,0,4,17,382,0
21,14,1,0,0,0,2,38,0
8,9,0,0,0,1,0,18,0
146,4,0,0,0,20,3,173,0
5,0,0,0,0,0,0,5,0
22,578,1,5,0,1,15,622,1
13,13,1,0,0,2,1,30,1
10,3,0,0,0,0,3,16,0
21,31,0,5,0,0,5,62,0
31,37,0,0,0,0,4,72,0
65,37,0,0,0,2,6,110,0
43,27,0,0,0,0,1,71,0
38,50,0,0,0,0,0,88,0
19,1,0,0,0,0,9,29,1
8,0,0,0,0,1,1,10,1
7,7,0,0,0,0,0,14,0
29,14,0,0,0,0,3,46,0
0,0,0,0,0,0,1,1,0
5,12,0,0,0,1,3,21,0
5,2,0,0,0,0,0,7,0
0,60,0,0,0,0,0,60,0
12,285,0,1,0,4,8,310,0
7,62,0,0,0,5,1,75,0
7,444,0,0,0,2,4,457,0
1,9,0,0,0,0,1,11,0
4,74,0,0,0,0,0,78,0
5,91,1,0,0,0,4,101,0
0,26,0,0,0,0,0,26,0
11,4,0,0,0,0,1,16,0
0,27,0,1,0,0,1,29,1
0,41,1,0,0,0,3,45,0
4,146,0,0,0,1,12,163,1
7,94,0,0,0,0,0,101,0
2,3,0,0,0,0,0,5,0
1,0,0,0,0,0,0,1,0
49,584,1,0,0,7,7,648,0
28,164,1,0,0,2,7,202,0
0,100,0,0,0,0,0,100,0
1,36,0,0,0,0,0,37,0
2,43,0,0,0,0,0,45,0
2,57,0,0,0,9,0,68,0
2,163,0,0,0,0,8,173,0
6,72,0,1,0,0,1,80,0
0,12,0,0,0,0,0,12,0
0,1,0,0,0,0,0,1,0
0,1,0,0,0,0,1,2,0
0,2,0,0,0,0,0,2,0
0,4,0,0,0,0,0,4,0
2,0,0,0,0,0,0,2,0
1,0,0,0,0,0,0,1,0
29,1,0,0,0,0,9,39,0
0,2,0,0,0,0,0,2,0
1,0,0,0,0,0,0,1,0
0,6,0,0,0,0,1,7,0
0,5,0,0,0,0,0,5,0
4,99,0,0,0,0,9,112,0
4,42,0,0,0,0,0,46,0
3,1,0,0,0,0,0,4,0
1,0,0,0,0,0,0,1,0
11,26,0,0,0,0,2,39,0
26,22,0,1,0,2,0,51,0
12,33,0,0,0,0,0,45,0
15,21,0,0,0,4,0,40,0
2,0,0,0,0,0,0,2,0
1,0,0,0,0,0,0,1,1
6,28,0,0,0,0,3,37,0
73,190,2,5,0,3,15,288,0
14,37,0,0,0,0,3,54,0
1,1,0,0,0,0,0,2,0
8,11,0,3,0,0,0,22,0
3,1,0,0,0,0,0,4,0
0,7,0,0,0,0,0,7,0
556,83,1,7,0,8,24,679,1
143,473,0,26,0,11,19,672,0
13,20,0,0,0,0,0,33,0
6,25,0,3,0,0,0,34,0
9,24,0,0,0,0,0,33,0
21,93,0,3,3,4,3,127,0
1,11,0,0,0,2,0,14,0
54,98,1,38,0,1,8,200,0
3,8,0,0,0,0,0,11,0
0,8,0,0,0,0,0,8,0
5,10,0,0,0,0,0,15,0
16,131,1,5,0,0,4,157,1
1,21,0,2,0,2,0,26,0
3,23,0,0,0,0,1,27,0
51,515,0,9,0,8,26,609,0
0,41,0,5,0,0,4,50,0
20,124,0,0,0,4,1,149,1
8,16,0,0,0,1,1,26,0
13,77,0,5,0,0,6,101,0
4,20,0,5,0,9,0,38,0
3,32,0,8,0,0,5,48,0
19,102,0,3,0,3,12,139,0
2,0,0,0,0,0,0,2,0
12,5,0,5,0,0,0,22,0
125,333,0,42,0,21,15,536,0
59,46,0,13,0,9,10,137,0
12,23,0,0,0,0,1,36,1
12,25,0,1,0,3,6,47,0
41,294,0,5,1,6,11,358,1
46,173,0,0,0,5,0,224,0
9,88,0,0,2,7,3,109,0
52,126,1,13,0,11,18,221,0
3,18,0,3,0,0,0,24,0
11,72,0,0,0,4,0,87,0
30,68,0,4,0,0,10,112,0
5,56,0,2,0,5,0,68,0
18,672,0,2,0,20,11,723,0
0,71,0,0,0,0,0,71,0
1,133,0,1,0,0,6,141,0
0,19,0,0,0,0,0,19,0
0,65,0,0,0,0,0,65,0
0,70,0,0,0,0,3,73,0
0,1,0,0,0,0,0,1,0
38,249,0,10,0,1,6,304,0
26,11,2,4,0,0,6,49,0
8,26,0,3,0,2,0,39,0
61,85,2,35,0,9,3,195,0
7,1,0,4,0,0,7,19,0
13,22,0,5,0,0,0,40,0
3,1,0,0,0,4,0,8,0
12,27,1,3,0,0,2,45,0
21,85,0,6,0,3,5,120,0
1,121,0,0,0,1,4,127,0
0,71,1,0,0,0,0,72,0
22,155,0,2,0,0,2,181,0
38,473,2,0,6,1,15,535,0
0,75,1,0,0,0,0,76,1
0,4,0,0,0,0,0,4,0
0,57,0,0,0,0,1,58,0
5,198,0,0,0,2,9,214,0
2,61,0,0,0,3,1,67,0
1,220,0,0,0,2,8,231,0
1,158,0,0,0,1,1,161,0
8,8,0,0,0,4,1,21,0
5,0,0,0,0,0,1,6,0
4,0,0,0,0,0,0,4,0
24,374,1,1,0,3,15,418,0
64,58,2,0,5,4,9,142,0
7,23,0,0,0,0,2,32,0
45,33,0,1,0,9,4,92,0
0,10,0,0,0,0,0,10,0
17,21,0,0,0,1,1,40,0
29,21,0,0,0,0,4,54,0
51,18,0,4,0,0,6,79,0
47,26,0,3,0,1,1,78,1
0,7,0,0,0,0,0,7,0
25,108,0,0,0,5,14,152,0
61,8,0,0,0,15,0,84,0
97,237,0,4,0,11,8,357,0
29,34,0,0,0,0,1,64,0
43,21,0,6,0,6,1,77,1
25,96,0,6,0,0,0,127,0
20,47,0,0,0,4,0,71,0
47,28,1,2,0,0,1,79,1
67,25,0,3,0,0,2,97,0
51,38,0,0,0,0,2,91,0
56,49,0,0,0,0,4,109,0
82,14,0,0,0,1,0,97,0
81,12,1,1,0,3,0,98,1
66,19,0,0,0,11,3,99,0
54,20,0,1,0,0,6,81,0
69,14,0,0,0,6,2,91,0
67,19,0,0,0,0,5,91,0
24,32,0,0,0,0,10,66,0
42,8,0,0,0,0,3,53,0
32,15,0,0,0,0,0,47,0
66,18,0,0,0,0,2,86,0
90,52,0,0,0,0,8,150,0
43,5,0,1,0,0,0,49,0
29,12,0,0,0,2,3,46,0
35,10,0,0,0,1,2,48,0
88,30,0,3,0,3,7,131,0
134,59,0,6,0,5,5,209,0
56,11,0,0,0,7,6,80,0
67,26,0,0,0,8,6,107,0
32,4,0,0,1,5,2,44,0
33,27,0,0,0,0,1,61,0
45,24,0,0,0,1,3,73,0
54,20,0,0,0,4,0,78,0
41,14,0,3,0,0,2,60,0
39,111,0,0,0,3,6,159,0
25,12,0,0,0,0,6,43,0
80,31,0,3,0,6,7,127,0
30,15,0,0,0,3,6,54,0
15,7,0,1,0,0,0,23,0
24,7,0,0,0,0,0,31,0
9,0,0,0,0,0,0,9,0
20,12,0,0,0,14,7,53,0
5,0,0,0,0,0,0,5,0
7,12,0,0,0,6,0,25,0
4,5,0,0,0,0,2,11,0
20,2,0,0,0,4,0,26,0
20,14,0,0,0,0,1,35,1
3,1,0,0,0,4,0,8,0
7,4,0,0,0,0,0,11,0
17,0,0,2,0,0,0,19,0
12,1,0,0,0,1,0,14,1
17,0,0,0,0,5,1,23,0
15,6,0,0,0,4,0,25,0
36,2,0,0,0,0,0,38,0
13,4,0,0,0,0,0,17,0
27,2,0,0,0,0,0,29,0
22,5,0,0,0,7,1,35,0
24,9,0,2,0,3,0,38,0
6,1,0,0,0,0,0,7,0
22,22,0,0,0,0,6,50,0
49,133,0,2,0,10,14,208,0
171,430,2,1,0,45,29,678,0
33,29,0,0,0,3,2,67,0
22,38,1,0,0,0,4,65,0
83,155,11,1,0,94,28,372,0
42,41,0,0,0,0,2,85,0
10,26,0,0,0,3,0,39,0
20,45,1,0,0,2,1,69,0
51,149,1,0,0,3,11,215,1
84,40,1,1,0,7,5,138,1
97,46,2,0,0,23,8,176,0
16,10,0,0,0,0,0,26,0
38,0,0,0,0,0,0,38,0
168,302,0,11,0,70,31,582,0
8,6,0,0,0,0,0,14,0
19,10,0,0,0,3,0,32,0
19,5,0,1,0,0,0,25,0
22,9,0,1,0,0,5,37,0
46,12,0,0,0,3,7,68,0
32,1,1,3,0,0,2,39,0
29,18,0,0,0,2,8,57,0
21,0,1,1,0,9,0,32,0
17,21,0,0,0,3,1,42,0
170,510,10,210,0,153,83,1136,0
42,10,0,0,0,0,0,52,0
37,10,0,0,0,4,2,53,0
39,4,0,1,0,0,0,44,0
18,8,0,0,0,0,0,26,0
11,11,1,0,0,0,0,23,0
14,8,0,0,0,4,1,27,0
26,4,0,5,0,0,0,35,0
24,5,0,0,0,0,0,29,0
39,6,0,3,0,0,0,48,0
46,8,0,0,0,4,0,58,0
52,12,1,0,0,9,3,77,0
109,52,0,18,0,10,8,197,0
40,38,0,19,0,0,3,100,0
25,19,0,0,0,0,7,51,0
20,11,0,0,0,3,0,34,0
85,2,0,0,0,5,4,96,0
44,2,0,0,0,0,7,53,0
35,1,0,0,0,5,0,41,0
27,10,0,1,0,0,2,40,0
25,8,0,0,0,0,0,33,0
62,16,0,0,0,3,4,85,0
32,13,0,3,0,0,0,48,0
38,10,0,1,0,4,7,60,0
102,35,1,0,0,4,6,148,0
24,32,0,0,0,0,4,60,0
40,15,0,0,0,0,2,57,0
20,10,0,0,0,0,0,30,0
64,6,0,6,0,2,6,84,0
39,14,0,12,0,5,2,72,0
62,54,1,0,0,5,0,122,0
24,31,0,3,0,8,0,66,0
40,5,0,6,0,0,2,53,0
78,116,0,17,0,0,9,220,0
21,34,0,4,0,0,5,64,0
109,17,1,0,0,4,5,136,0
30,2,0,1,0,0,0,33,0
52,13,0,0,0,7,6,78,0
41,7,2,8,0,3,3,64,0
158,72,1,6,0,10,5,252,0
46,23,0,1,0,8,2,80,0
25,9,0,0,0,5,0,39,0
4,0,0,0,0,0,0,4,0
2,0,0,0,0,0,0,2,0
43,25,0,9,0,0,0,77,0
79,37,0,0,0,17,0,133,0
5,2,0,0,0,0,0,7,0
2,3,0,4,0,0,0,9,0
5,5,0,0,0,0,0,10,0
113,297,1,6,0,1,16,434,0
44,12,1,5,0,6,0,68,1
48,7,0,0,0,0,0,55,0
40,6,0,3,0,0,0,49,0
46,7,0,0,0,0,0,53,0
44,16,0,3,0,0,1,64,0
49,77,0,0,0,6,9,141,0
25,15,0,10,0,0,5,55,0
29,14,0,0,0,3,7,53,0
57,8,0,11,0,0,2,78,0
59,9,0,0,0,0,1,69,0
51,13,0,0,0,0,2,66,0
41,1,0,5,0,0,1,48,1
75,51,0,0,0,2,6,134,0
69,4,0,0,1,0,1,75,0
38,10,0,7,0,0,0,55,0
80,17,2,0,0,1,4,104,0
39,9,0,1,0,0,6,55,1
9,2,0,8,0,6,0,25,0
143,147,3,0,0,47,31,371,0
42,35,0,6,2,15,5,105,0
68,0,0,2,0,0,1,71,0
47,11,4,0,0,0,0,62,0
41,11,0,0,0,0,1,53,0
26,0,0,0,0,0,0,26,0
31,2,1,0,0,0,0,34,0
56,20,0,6,0,1,0,83,0
133,20,3,3,0,7,16,182,0
47,12,0,1,0,0,0,60,0
41,12,0,0,0,0,1,54,0
49,2,0,0,1,0,0,52,0
23,6,0,5,0,0,0,34,0
51,4,0,0,0,0,2,57,0
296,64,1,6,0,0,12,379,0
49,10,0,0,0,0,0,59,0
94,16,0,3,0,0,1,114,0
0,0,0,0,0,0,1,1,0
62,6,0,0,0,0,0,68,0
30,0,0,0,0,0,0,30,0
24,2,0,0,0,0,0,26,0
50,4,0,5,0,0,0,59,0
63,38,0,1,0,22,3,127,0
68,1,0,4,0,0,0,73,0
33,5,0,2,0,2,1,43,0
70,1,1,0,0,0,0,72,0
80,5,0,0,0,0,0,85,0
44,2,0,3,0,0,0,49,0
56,16,0,0,0,0,2,74,0
125,20,0,0,0,0,0,145,0
32,4,0,0,0,0,0,36,0
7,0,0,0,0,0,0,7,0
77,9,0,1,0,0,4,91,0
9,0,0,0,0,0,0,9,0
23,0,0,1,0,0,3,27,0
15,0,0,1,0,0,0,16,0
52,4,0,2,0,0,5,63,0
53,1,0,1,0,0,0,55,0
44,3,0,0,0,0,0,47,0
22,0,0,1,0,0,0,23,0
82,0,0,2,0,0,0,84,0
37,7,0,0,0,0,0,44,0
28,0,0,0,0,0,1,29,1
52,0,0,2,0,0,1,55,0
52,0,0,0,0,0,2,54,0
71,0,0,0,0,0,0,71,0
5,0,0,0,0,0,1,6,0
40,0,0,0,0,0,2,42,0
33,0,0,1,0,1,0,35,0
38,0,0,0,0,0,1,39,0
263,3,0,9,0,3,9,287,0
32,0,0,0,0,0,0,32,0
68,0,0,4,0,1,3,76,0
50,5,0,6,0,0,5,66,0
68,0,0,2,0,0,0,70,0
224,5,1,18,0,3,2,253,0
19,0,0,0,0,0,0,19,0
48,0,0,0,0,0,0,48,0
18,0,0,0,0,0,0,18,0
50,0,0,3,0,0,2,55,0
41,0,0,0,0,0,0,41,0
142,1,0,1,0,4,3,151,0
66,1,0,1,0,0,1,69,0
54,2,0,0,0,1,0,57,0
56,0,0,5,0,0,1,62,0
20,2,0,0,0,0,0,22,0
28,0,0,0,0,0,0,28,0
22,0,0,2,0,0,0,24,0
23,0,0,0,0,0,0,23,0
24,0,0,0,0,0,0,24,0
21,1,1,0,0,0,0,23,1
38,0,0,2,0,0,3,43,0
52,1,0,1,0,0,2,56,0
14,0,0,0,0,0,0,14,0
34,6,0,1,0,0,0,41,0
21,0,0,3,0,2,0,26,0
43,3,0,0,0,0,0,46,0
16,0,0,0,0,0,1,17,0
15,0,0,1,0,0,0,16,0
32,2,0,2,0,0,0,36,0
26,0,0,0,0,0,0,26,0
25,1,0,0,0,0,0,26,0
46,1,0,0,0,3,5,55,0
60,1,1,0,0,0,5,67,1
59,0,0,0,0,0,0,59,0
33,4,0,7,0,0,3,47,0
43,0,0,1,0,0,0,44,0
55,0,0,6,0,0,2,63,0
38,0,0,2,0,0,0,40,0
162,23,1,65,0,2,9,262,0
118,16,0,5,0,2,6,147,0
69,10,0,6,0,0,3,88,0
38,0,0,8,0,0,0,46,0
36,0,0,0,0,0,1,37,0
38,1,1,0,0,0,0,40,0
17,0,0,0,0,0,0,17,0
66,2,0,2,0,0,0,70,0
515,32,0,34,0,14,33,628,0
41,6,0,2,0,0,3,52,0
115,13,0,0,0,4,3,135,0
88,5,0,1,0,0,3,97,0
32,0,0,0,0,0,0,32,0
159,27,0,4,0,2,1,193,0
34,0,0,0,0,1,1,36,0
44,0,0,1,0,0,2,47,0
103,0,0,0,0,0,0,103,0
76,0,0,0,0,0,0,76,0
35,0,0,2,0,0,0,37,0
46,2,0,0,0,1,0,49,1
80,5,0,0,0,0,1,86,0
45,6,0,5,0,0,2,58,0
50,0,0,1,0,5,1,57,0
31,0,0,0,0,0,4,35,0
2,0,0,0,0,0,0,2,0
238,11,0,7,0,5,8,269,0
319,31,1,12,0,1,6,370,0
156,6,0,6,0,0,6,174,0
71,0,0,0,2,0,4,77,0
195,14,0,17,0,2,0,228,0
89,1,0,3,0,1,0,94,0
167,8,0,6,0,0,3,184,0
18,0,0,3,0,0,0,21,0
54,3,0,1,0,0,4,62,0
114,13,0,2,0,0,2,131,0
47,0,0,0,0,0,0,47,0
28,0,0,0,0,0,0,28,0
126,4,0,9,0,0,0,139,0
36,1,0,0,0,0,0,37,1
38,0,0,0,0,0,1,39,0
31,0,0,1,0,0,0,32,0
273,2,0,6,0,1,15,297,0
48,6,0,0,0,0,0,54,0
35,2,0,7,0,0,6,50,0
38,0,0,0,0,0,0,38,0
17,2,0,14,0,0,0,33,0
295,18,3,158,0,3,24,501,0
51,32,0,88,2,0,5,178,0
192,8,0,38,0,4,6,248,0
597,175,2,294,0,34,53,1155,0
356,47,1,338,0,37,26,805,1
84,13,0,20,0,5,2,124,0
24,4,0,4,0,0,0,32,0
351,49,2,284,0,1,12,699,0
156,14,0,96,0,1,8,275,0
42,1,0,2,0,0,0,45,0
91,2,0,5,0,1,10,109,0
41,0,1,0,0,0,0,42,0
79,4,1,7,1,0,0,92,0
61,1,1,1,0,0,3,67,0
44,0,0,2,0,0,0,46,0
34,0,0,2,0,0,0,36,0
23,0,0,0,0,0,6,29,0
28,0,0,1,0,0,0,29,1
85,5,0,3,0,0,2,95,0
2,0,0,0,0,0,0,2,0
35,0,0,8,0,2,6,51,0
185,12,0,38,0,4,7,246,0
327,24,0,146,0,9,12,518,0
12,0,0,1,0,0,1,14,0
180,9,2,29,0,3,4,227,0
234,15,0,38,0,4,4,295,0
27,2,0,4,0,0,1,34,1
130,1,5,12,0,0,5,153,0
43,0,0,1,0,0,2,46,0
312,25,0,29,0,5,6,377,0
179,10,5,10,0,1,6,211,0
30,0,0,2,0,0,2,34,0
109,0,0,0,0,0,5,114,0
98,1,0,2,0,0,1,102,0
105,0,0,0,0,0,0,105,0
71,0,0,0,0,0,0,71,0
103,1,0,0,0,2,7,113,0
117,0,0,0,0,0,2,119,0
68,0,0,4,0,0,0,72,0
44,0,0,0,0,0,4,48,0
181,0,0,5,0,1,5,192,0
40,0,0,0,0,0,0,40,0
50,0,0,0,0,0,0,50,0
6,0,0,0,0,0,0,6,0
4,0,0,0,0,0,0,4,0
0,4,0,0,0,0,0,4,0
1,0,0,0,0,0,0,1,0
60,0,0,3,0,0,0,63,0
3,0,0,0,0,0,0,3,0
13,0,0,0,0,0,2,15,0
14,0,0,0,0,0,0,14,0
16,6,0,1,0,0,0,23,1
10,0,0,0,0,0,0,10,0
4,0,0,0,0,0,0,4,0
131,2,0,1,0,0,0,134,0
8,0,0,0,0,0,0,8,0
2,0,0,0,0,0,0,2,0
7,0,0,0,0,0,0,7,0
18,0,0,0,0,0,0,18,0
36,2,0,0,0,2,0,40,0
18,0,0,0,0,0,0,18,0
7,0,0,0,0,0,0,7,0
30,0,0,0,0,0,0,30,0
44,0,0,0,1,0,0,45,0
10,0,0,3,0,0,2,15,0
9,0,0,0,0,0,0,9,0
2,0,0,0,0,0,0,2,0
5,0,0,0,0,0,0,5,0
6,0,0,0,0,0,0,6,0
133,0,0,0,0,0,4,137,0
8,0,0,0,0,0,0,8,0
161,2,0,34,0,0,12,209,0
52,0,0,9,0,0,0,61,0
118,4,3,13,0,2,1,141,1
7,0,0,9,0,0,2,18,0
96,0,0,8,0,0,3,107,0
47,4,0,5,0,0,2,58,0
37,0,0,8,0,5,1,51,0
124,7,0,37,0,0,7,175,0
48,0,0,21,0,0,0,69,0
11,0,0,0,0,0,0,11,0
54,0,0,18,0,0,3,75,0
50,21,0,4,0,0,0,75,0
4,0,0,0,0,0,0,4,0
249,9,0,4,0,0,7,269,0
187,0,0,22,0,0,0,209,0
54,1,0,10,0,1,4,70,0
40,0,0,6,0,0,1,47,0
37,0,0,7,0,0,0,44,0
8,0,0,0,0,0,0,8,0
24,2,0,9,0,0,1,36,0
38,0,1,1,0,0,2,42,0
1,0,0,0,0,0,0,1,1
9,0,0,0,0,0,0,9,0
3,0,0,0,0,0,0,3,0
30,3,0,3,0,0,0,36,0
80,0,0,17,0,0,0,97,0
28,0,0,14,0,0,2,44,0
271,14,1,59,0,2,14,361,0
19,0,0,2,0,0,0,21,0
28,0,0,0,0,0,0,28,0
47,0,0,1,0,0,0,48,0
19,0,0,0,0,0,1,20,0
27,0,0,0,0,0,0,27,0
23,1,0,0,0,0,0,24,0
26,3,0,0,0,0,0,29,0
32,0,0,0,0,0,0,32,0
34,0,0,0,0,0,0,34,0
40,0,0,6,0,0,1,47,0
99,3,0,8,0,0,4,114,0
33,0,0,0,0,0,0,33,0
15,0,0,1,0,0,0,16,1
3,0,0,0,0,0,0,3,0
0,4,0,0,0,0,0,4,0
64,3,0,10,0,0,0,77,0
32,0,0,2,0,0,0,34,0
30,0,0,6,0,0,0,36,0
31,0,0,4,0,0,0,35,0
5,0,0,0,0,0,0,5,0
300,2,1,5,0,1,0,309,0
4,0,0,0,0,0,0,4,0
126,5,0,4,0,0,6,141,0
157,0,0,7,0,0,10,174,0
0,0,0,4,0,0,0,4,0
3,1,0,0,0,0,3,7,0
12,0,0,1,0,0,0,13,1
30,0,0,3,0,0,0,33,0
0,0,0,0,0,0,2,2,0
185,0,0,8,0,4,0,197,0
154,14,0,5,0,0,0,173,0
217,21,0,1,0,9,6,254,1
198,62,0,6,0,0,13,279,0
19,41,0,8,0,0,4,72,0
89,23,0,0,7,0,0,119,0
56,71,0,8,0,0,8,143,0
173,4,0,17,1,5,8,208,0
37,0,0,1,0,0,0,38,0
54,5,0,7,0,0,4,70,0
42,0,0,11,0,0,0,53,0
476,19,2,20,0,1,10,528,0
50,0,0,7,0,3,0,60,0
48,1,0,8,0,0,0,57,0
7,0,0,0,0,0,0,7,0
39,1,0,13,0,0,2,55,0
10,0,0,0,0,0,0,10,0
14,0,0,0,0,0,0,14,0
379,5,3,18,0,0,11,416,0
158,0,0,1,0,0,0,159,0
23,0,0,0,0,0,0,23,0
105,1,0,10,0,0,2,118,0
16,0,0,0,0,0,0,16,0
87,0,0,5,0,0,0,92,0
75,1,0,3,0,0,0,79,0
100,0,0,6,0,0,3,109,0
25,0,0,0,0,0,0,25,0
241,2,0,10,0,1,6,260,0
125,2,0,13,0,0,0,140,0
36,0,0,3,0,0,3,42,0
15,0,0,0,0,0,0,15,0
6,0,0,0,0,0,0,6,0
1,0,0,0,0,0,0,1,1
8,0,0,0,0,0,0,8,0
56,0,0,0,0,0,0,56,0
6,0,0,0,0,0,0,6,0
17,0,0,4,0,0,1,22,0
2,0,0,0,0,0,0,2,0
63,1,1,4,0,0,0,69,0
19,1,0,0,0,0,1,21,0
571,9,0,9,0,0,13,602,0
222,4,0,0,0,0,0,226,0
103,0,0,12,0,0,4,119,0
88,0,0,15,0,0,0,103,0
38,1,0,0,0,0,0,39,1
170,5,0,9,0,0,7,191,0
47,0,0,4,0,0,0,51,0
182,18,4,3,0,3,12,222,0
218,4,0,25,0,10,9,266,0
99,19,0,5,0,12,6,141,0
224,6,0,7,0,0,2,239,0
182,12,1,10,0,4,6,215,0
2,0,0,0,0,0,0,2,0
39,0,0,1,0,2,0,42,0
20,0,0,0,0,0,0,20,0
173,0,0,7,0,1,3,184,0
69,0,0,3,0,0,0,72,0
96,6,3,12,0,1,4,122,0
53,8,2,5,0,5,0,73,0
89,1,0,1,0,0,2,93,0
83,0,0,0,0,7,3,93,0
71,5,0,0,0,0,5,81,0
63,0,0,0,0,0,0,63,0
99,0,0,0,0,0,5,104,0
55,0,0,9,0,1,0,65,0
74,0,0,0,0,7,2,83,0
58,2,0,0,0,0,0,60,0
67,0,0,0,0,3,1,71,0
119,0,1,0,0,2,0,122,0
199,2,1,2,0,25,7,236,0
142,2,0,7,0,5,12,168,0
55,5,0,0,0,0,0,60,0
69,4,0,2,0,0,1,76,0
95,3,0,4,0,0,7,109,0
77,0,0,2,0,0,5,84,0
44,0,0,4,0,0,0,48,0
59,4,1,0,0,0,2,66,0
72,4,0,1,0,0,0,77,0
46,10,0,0,0,0,0,56,0
186,0,1,14,0,7,5,213,0
82,1,0,0,0,0,0,83,0
74,0,0,0,0,1,0,75,1
165,2,0,9,0,0,0,176,0
48,0,0,0,0,0,0,48,0
9,0,0,0,0,2,0,11,0
14,0,0,1,0,0,0,15,1
107,0,0,4,0,1,5,117,0
55,3,0,0,0,2,0,60,0
28,0,0,0,0,0,0,28,0
1,0,0,1,0,0,2,4,0
23,1,0,0,0,0,0,24,0
265,35,0,9,0,13,10,332,0
118,9,0,13,0,0,5,145,0
10,0,0,0,0,0,0,10,0
21,0,0,0,0,0,0,21,0
36,0,0,0,0,0,0,36,0
122,6,2,1,0,5,9,145,0
211,7,3,0,0,6,3,230,0
27,0,0,0,0,0,0,27,0
47,0,0,0,0,0,0,47,0
51,0,0,0,0,0,0,51,0
94,0,0,1,0,1,0,96,0
136,1,1,0,0,0,4,142,1
54,0,0,0,0,0,0,54,0
96,0,0,0,0,0,4,100,0
89,7,1,0,0,0,0,97,0
80,0,0,0,0,0,0,80,0
82,2,0,0,0,0,0,84,0
53,4,0,0,0,0,0,57,0
112,0,0,4,0,0,0,116,0
70,0,0,0,0,0,0,70,0
53,0,0,0,0,0,0,53,0
44,0,0,0,0,0,0,44,0
266,5,0,10,0,1,4,286,0
71,3,0,2,0,0,2,78,0
41,2,0,0,0,0,1,44,1
1,0,0,1,0,0,0,2,0
0,2,0,0,0,0,0,2,0
109,1,0,2,0,6,1,119,0
146,5,0,2,0,0,4,157,0
146,3,0,0,0,0,7,156,0
102,4,0,3,0,9,1,119,1
127,1,0,0,0,0,0,128,0
192,1,0,12,0,5,8,218,0
87,1,0,12,0,0,3,103,0
80,1,0,17,0,1,2,101,1
177,5,1,25,0,3,3,214,0
72,1,0,3,0,0,3,79,0
100,1,0,5,0,0,13,119,0
57,1,0,13,0,0,0,71,0
118,7,0,3,0,13,4,145,0
46,7,0,3,0,8,2,66,0
133,8,0,3,0,0,1,145,1
51,0,0,1,0,0,0,52,0
23,1,0,0,0,0,0,24,0
46,3,2,2,0,0,4,57,0
11,0,0,0,0,0,0,11,0
10,5,0,0,0,0,0,15,0
25,8,0,0,0,0,2,35,0
15,1,0,4,0,0,0,20,0
132,2,0,3,0,3,6,146,0
383,29,3,36,0,18,13,482,0
7,0,0,4,0,0,4,15,0
103,5,0,0,0,0,3,111,0
147,4,0,13,0,0,5,169,0
293,10,0,9,0,0,9,321,0
88,4,0,0,0,2,0,94,0
68,15,0,0,0,0,0,83,0
144,2,0,1,0,3,1,151,0
80,0,0,4,0,0,2,86,0
61,1,0,0,0,0,2,64,0
28,1,0,14,0,0,3,46,0
71,4,0,0,0,0,2,77,0
118,7,0,7,0,0,2,134,0
55,0,0,9,0,1,0,65,1
676,32,2,31,0,9,20,770,0
20,0,0,5,0,0,0,25,0
23,1,0,1,0,3,0,28,0
6,3,0,0,0,0,0,9,0
126,0,0,0,0,2,0,128,0
20,0,0,0,0,0,1,21,0
19,0,0,0,0,0,0,19,0
71,0,0,9,0,0,1,81,0
27,1,0,3,0,2,3,36,0
184,2,1,3,0,0,2,192,1
8,1,0,0,0,0,1,10,0
255,3,3,12,0,2,3,278,0
54,12,0,14,0,1,0,81,0
23,0,0,0,0,0,0,23,0
4,0,0,0,0,0,0,4,0
67,5,0,0,0,0,1,73,0
59,0,0,2,0,0,0,61,0
71,0,0,1,0,1,4,77,1
51,0,0,4,0,1,0,56,0
206,16,0,52,0,1,7,282,0
1,0,0,0,0,0,0,1,1
57,3,0,11,0,0,0,71,0
49,0,0,10,0,0,0,59,0
37,1,0,8,0,1,4,51,0
81,10,0,34,0,2,6,133,0
56,0,1,9,0,0,5,71,0
47,3,0,0,0,0,0,50,0
48,4,0,11,0,0,3,66,0
1,0,0,0,0,0,0,1,1
271,26,0,10,0,23,9,339,0
57,1,0,0,2,0,1,61,0
64,0,0,0,0,0,0,64,0
59,5,0,0,0,0,5,69,0
30,0,0,9,0,0,0,39,0
30,0,0,0,0,0,2,32,0
23,8,0,0,0,4,1,36,0
95,1,0,3,0,0,3,102,0
57,12,0,0,0,3,0,72,0
30,4,0,10,0,0,0,44,0
288,8,0,17,1,5,5,324,0
42,2,0,0,0,0,0,44,0
74,1,0,0,0,0,3,78,0
131,0,0,8,0,0,0,139,0
57,1,0,0,0,0,0,58,0
49,0,0,0,0,0,0,49,0
12,0,0,0,0,0,0,12,0
0,3,0,0,0,0,1,4,0
1,0,0,0,0,0,0,1,0
4,0,0,0,0,0,0,4,0
0,0,0,0,0,0,1,1,0
2,1,0,0,0,0,2,5,1
2,0,0,0,0,0,0,2,0
77,8,0,9,0,7,0,101,0
114,5,0,2,0,0,2,123,0
805,11,6,47,0,1,28,898,0
1,0,0,0,0,0,1,2,1
58,0,0,4,0,0,2,64,0
7,0,0,0,0,0,0,7,0
44,1,0,3,0,0,0,48,0
4,3,0,0,0,0,1,8,0
43,0,0,1,0,0,1,45,0
231,6,0,31,0,0,6,274,0
23,5,0,0,0,0,0,28,0
58,0,0,4,0,0,0,62,0
3,0,0,0,0,0,0,3,0
0,0,0,3,0,0,0,3,0
1,0,0,0,0,0,0,1,0
126,4,0,17,0,0,2,149,0
8,0,0,0,0,0,0,8,0
223,10,0,56,0,5,9,303,0
10,2,0,0,0,0,0,12,0
7,2,0,6,0,0,0,15,0
8,0,0,1,0,0,0,9,0
7,0,0,1,0,0,0,8,1
8,0,0,2,0,0,0,10,0
8,1,0,2,0,0,0,11,0
14,0,0,4,0,0,0,18,0
8,1,0,0,0,0,0,9,0
22,0,1,0,0,0,0,23,0
19,1,0,0,0,0,0,20,0
18,1,0,0,0,0,0,19,0
10,0,0,0,0,0,0,10,0
152,30,0,1,0,16,22,221,1
41,0,0,1,0,0,2,44,0
19,0,0,0,0,0,0,19,0
55,1,0,0,0,3,3,62,0
50,3,0,0,0,0,0,53,0
65,16,6,4,0,7,3,101,0
75,5,0,5,0,1,2,88,0
25,9,0,2,0,4,3,43,0
10,0,0,1,0,0,0,11,0
14,0,0,2,0,0,0,16,0
4,0,0,0,0,0,0,4,0
67,2,0,8,0,0,1,78,0
54,9,0,1,0,0,1,65,0
64,0,0,12,0,0,0,76,0
18,0,1,1,0,0,1,21,0
90,5,0,0,0,0,5,100,0
208,51,3,5,0,5,20,292,0
9,1,0,0,0,0,1,11,1
8,0,0,2,0,0,0,10,0
16,0,0,0,0,0,1,17,0
8,0,0,2,0,0,0,10,0
8,1,0,4,0,0,0,13,0
42,0,0,1,0,0,2,45,0
10,0,0,3,0,0,0,13,0
3,0,0,0,0,0,0,3,0
11,4,0,0,0,0,0,15,0
44,0,0,9,0,0,0,53,0
22,0,0,0,0,0,3,25,0
332,20,0,20,0,0,4,376,0
11,0,0,10,0,0,0,21,0
47,0,0,9,0,0,0,56,0
48,0,0,1,0,0,0,49,0
12,0,0,0,0,0,3,15,0
6,0,0,0,0,0,0,6,0
2,0,0,0,0,0,0,2,0
75,0,0,2,0,0,0,77,0
43,0,0,0,0,0,0,43,0
24,0,0,5,0,0,0,29,0
88,0,0,6,0,0,0,94,0
5,0,0,0,0,0,0,5,0
3,0,0,0,0,0,0,3,0
28,0,0,0,0,0,0,28,0
54,0,0,6,0,0,0,60,0
121,1,0,3,0,0,2,127,1
103,9,0,1,0,0,3,116,0
44,0,0,1,0,0,1,46,1
24,0,0,0,0,0,0,24,0
141,2,0,2,0,2,1,148,0
38,0,0,0,0,0,0,38,0
18,0,0,0,0,0,0,18,0
104,2,2,2,0,4,6,120,0
4,0,0,0,0,0,0,4,0
9,0,0,0,0,0,1,10,0
51,0,0,0,0,0,0,51,0
18,2,0,0,0,0,0,20,0
17,4,0,0,0,0,2,23,0
88,0,0,24,0,0,3,115,0
64,0,0,4,0,0,2,70,0
171,8,0,1,0,0,0,180,0
57,1,0,0,0,2,1,61,0
88,0,0,0,0,1,4,93,0
102,1,0,1,0,0,1,105,0
55,2,0,0,0,0,0,57,0
50,7,0,7,0,0,0,64,0
108,0,0,5,0,0,0,113,0
21,0,0,1,0,0,2,24,0
60,1,0,1,0,0,3,65,0
36,0,0,1,0,1,1,39,1
32,0,0,0,0,0,0,32,0
31,0,0,0,0,3,0,34,0
146,0,0,9,0,0,0,155,0
44,0,0,0,0,0,0,44,0
18,0,0,4,0,0,0,22,0
179,4,0,9,0,0,8,200,0
92,0,0,2,0,0,0,94,0
38,0,0,4,0,0,0,42,0
90,1,0,2,0,0,0,93,1
69,0,0,1,0,0,0,70,0
142,0,0,11,0,2,0,155,0
61,0,0,3,0,0,1,65,0
63,0,0,9,0,0,0,72,0
73,0,0,4,0,0,0,77,0
98,0,0,10,0,1,1,110,1
121,0,0,0,0,0,0,121,0
27,2,0,4,0,0,0,33,0
21,0,0,0,0,0,0,21,0
49,0,0,0,0,0,0,49,0
14,0,0,0,0,0,0,14,0
4,0,0,0,0,0,0,4,0
28,0,0,0,0,0,0,28,0
5,0,0,0,0,0,0,5,0
57,0,0,3,0,0,4,64,0
13,0,0,0,0,0,0,13,0
93,1,0,0,0,0,2,96,0
46,0,0,0,0,0,0,46,0
6,0,0,0,0,0,0,6,0
5,0,0,0,0,0,0,5,0
191,2,0,3,0,0,7,203,0
9,0,0,0,0,0,0,9,0
17,0,0,0,0,0,0,17,0
69,0,0,0,0,0,0,69,0
16,0,0,0,0,0,0,16,0
19,0,0,0,0,0,0,19,0
33,0,0,0,0,0,0,33,0
18,0,0,0,0,0,0,18,0
2,0,0,0,0,0,0,2,0
11,0,0,0,0,0,0,11,0
7,0,0,1,0,0,2,10,1
23,0,0,0,0,0,0,23,0
15,0,0,0,0,0,0,15,0
20,0,0,0,0,0,0,20,0
109,0,0,2,0,0,4,115,0
138,0,0,6,0,0,9,153,0
119,1,0,0,0,3,1,124,0
79,0,0,0,0,0,0,79,0
100,2,0,0,0,0,2,104,0
142,0,0,0,0,0,1,143,1
13,0,0,0,0,0,0,13,0
6,0,0,0,0,0,0,6,0
42,0,0,0,0,0,0,42,0
38,0,0,0,0,0,0,38,0
136,0,0,0,0,0,1,137,0
72,0,0,2,0,0,6,80,0
17,0,0,2,0,0,0,19,0
17,0,0,0,0,0,0,17,0
45,0,0,0,0,0,0,45,0
20,0,0,0,0,0,0,20,0
17,0,0,0,0,0,0,17,0
38,0,0,0,0,0,0,38,0
191,1,0,21,0,0,3,216,0
89,0,0,10,0,0,2,101,0
118,1,0,2,0,0,0,121,0
86,0,0,0,0,3,1,90,1
124,0,0,0,0,0,0,124,0
13,0,0,0,0,0,0,13,0
29,0,0,6,0,0,0,35,0
38,1,0,1,0,0,0,40,0
26,0,0,0,0,0,0,26,0
11,0,0,0,0,0,0,11,0
90,1,0,8,0,0,1,100,0
3,0,0,0,0,0,0,3,0
30,0,0,0,0,0,0,30,0
16,0,0,0,0,0,1,17,0
1,0,0,1,0,0,0,2,0
111,2,0,0,0,0,0,113,0
16,0,0,0,0,0,0,16,0
45,0,0,2,0,0,2,49,0
4,0,0,0,0,0,0,4,0
280,6,0,6,0,0,11,303,0
86,0,0,4,0,0,3,93,0
16,0,0,0,0,0,0,16,0
74,1,3,2,0,0,2,82,0
45,0,0,15,0,0,2,62,0
185,1,0,0,0,0,1,187,0
22,0,0,0,0,0,0,22,0
51,6,0,0,0,0,3,60,0
144,0,1,3,0,1,6,155,0
91,1,0,2,0,0,2,96,0
24,0,0,0,0,0,0,24,0
46,0,0,10,0,3,1,60,0
36,0,0,1,0,0,0,37,0
73,2,0,6,0,0,2,83,0
97,6,1,0,0,0,0,104,0
39,0,0,0,0,0,0,39,0
50,0,0,1,0,0,0,51,0
29,0,0,0,0,0,0,29,0
37,0,0,2,0,0,0,39,0
96,0,0,2,0,0,1,99,1
55,0,0,0,0,0,0,55,0
36,0,0,1,0,0,0,37,0
26,4,0,0,0,0,0,30,0
109,2,0,2,0,6,5,124,0
64,5,1,0,0,8,2,80,0
85,0,0,0,0,0,0,85,0
47,0,0,1,0,0,0,48,0
168,3,1,3,0,0,5,180,0
12,0,0,0,0,0,0,12,0
81,1,1,0,0,0,0,83,1
31,0,0,0,0,0,0,31,0
67,1,0,3,0,0,6,77,1
34,1,0,0,0,0,2,37,0
38,0,0,0,0,1,3,42,1
5,1,1,0,0,0,0,7,0
6,0,0,0,0,0,0,6,0
16,0,0,0,0,1,2,19,0
10,6,0,0,0,0,0,16,0
9,0,0,0,0,0,0,9,0
18,0,0,0,0,0,0,18,0
14,0,0,0,0,0,0,14,0
110,10,0,3,0,0,4,127,0
50,1,0,1,0,0,2,54,0
37,1,0,2,0,0,1,41,1
51,0,2,0,0,1,1,55,0
28,1,0,0,0,0,5,34,0
16,0,0,0,0,0,0,16,0
28,0,0,0,0,0,0,28,0
41,0,0,0,0,0,0,41,0
388,9,3,21,0,6,10,437,0
85,1,0,6,0,1,0,93,1
28,0,0,2,0,0,0,30,0
5,0,0,0,0,0,0,5,0
27,2,0,4,0,0,0,33,0
14,0,0,0,0,2,0,16,0
14,0,0,0,0,0,0,14,0
41,0,0,2,0,0,0,43,0
103,0,0,2,0,0,2,107,0
108,0,0,12,0,0,1,121,0
51,0,0,2,0,0,0,53,0
139,1,0,46,0,0,6,192,0
26,0,0,12,0,0,1,39,0
27,1,1,13,0,4,3,49,0
76,2,0,5,0,0,2,85,0
64,4,0,3,0,0,1,72,0
3,0,0,0,0,0,0,3,0
63,0,0,0,0,0,0,63,0
34,0,0,1,0,0,3,38,0
88,2,0,0,0,0,5,95,0
10,0,0,0,0,0,0,10,0
16,0,0,0,0,0,0,16,0
5,0,0,0,0,0,0,5,0
58,0,0,0,0,0,0,58,0
53,0,0,0,0,0,0,53,0
23,0,0,0,0,0,0,23,0
24,0,0,2,0,0,0,26,0
9,0,0,0,0,0,0,9,0
97,1,1,0,0,0,0,99,0
19,0,0,0,0,0,0,19,0
33,0,0,0,0,0,0,33,0
1,0,0,1,0,0,3,5,0
26,2,0,1,0,0,0,29,0
77,0,0,6,4,0,0,87,0
231,16,0,38,0,5,3,293,0
48,0,0,0,0,0,1,49,0
50,2,0,9,0,0,0,61,0
117,4,0,0,0,0,5,126,0
68,4,0,8,0,0,2,82,0
127,9,0,4,0,0,4,144,0
105,9,0,13,0,0,1,128,0
85,16,0,15,0,1,0,117,1
30,1,0,2,0,3,1,37,2
76,1,0,2,0,6,6,91,0
13,0,0,0,0,0,0,13,0
8,0,0,0,0,1,0,9,0
60,6,0,2,0,3,2,73,0
17,5,0,0,0,0,0,22,0
9,0,0,1,0,0,0,10,0
109,3,1,3,0,0,12,128,0
17,1,0,2,0,0,0,20,0
23,4,0,5,0,7,2,41,0
4,0,0,0,0,0,0,4,0
17,2,0,0,0,2,0,21,0
24,0,0,0,0,0,0,24,0
73,3,0,0,0,0,5,81,0
21,3,0,0,0,0,0,24,0
20,0,0,4,0,2,0,26,0
90,4,0,4,0,7,4,109,0
101,4,0,0,0,1,2,108,0
141,1,0,5,0,0,0,147,0
57,1,0,0,0,0,2,60,1
24,0,0,0,0,0,0,24,0
144,0,0,12,0,0,4,160,0
700,209,0,34,0,15,34,992,0
50,8,0,4,0,0,0,62,0
136,3,0,11,0,0,5,155,0
9,0,0,0,0,0,0,9,0
113,0,0,12,0,1,2,128,0
9,0,0,0,0,0,0,9,0
65,2,0,1,0,1,1,70,2
93,0,0,5,0,0,0,98,0
6,0,0,0,0,0,0,6,0
32,85,0,0,12,5,4,138,0
2,0,0,0,0,0,0,2,0
218,5,0,3,0,6,8,240,0
70,1,0,0,0,3,1,75,0
81,10,0,0,0,0,6,97,0
41,5,0,1,0,0,4,51,0
33,0,0,10,0,0,0,43,0
69,4,0,10,0,0,0,83,0
80,8,0,15,0,0,3,106,0
45,0,0,2,0,9,0,56,0
99,1,1,9,0,0,0,110,2
49,0,0,1,0,1,4,55,1
18,0,0,0,0,0,0,18,0
25,0,0,0,0,0,0,25,0
18,0,0,0,0,0,0,18,0
32,9,0,3,0,4,0,48,0
27,0,0,0,0,0,3,30,0
28,0,0,0,0,0,0,28,0
38,0,0,0,0,0,0,38,0
62,0,0,0,0,0,0,62,0
70,1,0,0,0,0,1,72,1
45,0,1,1,0,0,3,50,1
47,0,0,0,0,4,3,54,0
29,0,0,5,0,0,0,34,0
30,0,0,0,0,0,0,30,0
53,0,0,0,0,5,2,60,0
24,0,3,0,0,0,1,28,0
48,1,0,3,0,0,2,54,0
68,1,0,6,0,0,2,77,1
73,2,0,1,0,0,0,76,1
31,2,0,3,0,0,2,38,0
48,4,0,6,0,0,0,58,0
76,4,0,5,0,5,4,94,0
91,5,0,3,0,0,2,101,0
99,6,2,7,0,0,7,121,0
6,0,0,1,0,0,1,8,0
23,8,0,2,0,0,0,33,0
38,3,0,0,0,0,1,42,0
31,2,0,0,0,0,0,33,0
29,2,0,10,0,0,8,49,0
45,5,0,12,0,0,0,62,0
81,8,0,5,0,0,4,98,0
26,4,0,11,0,0,1,42,0
48,0,0,0,0,0,1,49,0
31,6,0,4,0,0,0,41,0
37,4,0,0,0,0,2,43,0
37,1,0,0,0,0,0,38,0
5,0,0,0,0,0,0,5,0
128,5,0,41,0,1,4,179,0
32,6,0,23,0,0,8,69,0
40,10,0,11,0,0,3,64,0
539,39,0,40,0,20,20,658,0
75,6,0,5,0,0,2,88,0
79,31,0,18,0,5,0,133,0
15,0,0,0,0,0,0,15,0
16,0,0,0,0,0,0,16,0
38,3,0,5,0,0,3,49,0
7,0,0,0,0,0,0,7,0
4,2,0,0,0,0,0,6,0
65,8,1,11,0,1,13,99,0
283,41,0,29,0,28,18,399,0
52,2,0,1,0,15,0,70,0
222,3,0,13,0,0,3,241,0
29,3,0,8,0,0,0,40,0
19,0,0,0,0,0,0,19,0
180,4,0,22,0,0,2,208,0
50,6,0,5,0,0,1,62,0
497,180,2,50,6,11,7,753,0
51,0,0,4,0,2,5,62,0
25,33,0,0,0,4,7,69,0
107,9,0,17,0,11,0,144,0
86,6,0,4,0,6,3,105,0
223,20,0,40,0,0,2,285,0
41,5,0,11,0,0,0,57,0
85,0,0,0,0,4,0,89,0
86,2,1,0,0,0,10,99,0
44,0,0,0,0,0,4,48,0
25,6,0,0,0,2,3,36,0
913,246,4,67,0,205,69,1504,0
70,7,1,1,0,0,6,85,0
81,18,0,3,0,15,3,120,0
71,81,0,0,0,61,8,221,0
46,8,0,0,0,16,6,76,0
30,15,0,11,0,4,0,60,0
76,9,1,0,0,11,3,100,0
55,0,0,1,0,4,0,60,0
19,5,0,0,1,11,2,38,0
54,0,0,6,0,0,0,60,0
24,0,0,4,0,6,6,40,0
22,48,0,0,0,10,2,82,0
37,0,0,0,0,0,0,37,0
103,14,0,6,0,19,3,145,0
274,13,0,2,0,1,10,300,0
38,9,0,0,0,1,0,48,0
50,0,0,0,0,1,0,51,1
17,3,0,2,0,0,0,22,0
43,4,0,1,0,2,0,50,0
36,0,0,4,0,7,0,47,0
51,14,0,0,0,0,0,65,0
51,5,0,7,0,0,0,63,0
80,6,0,22,0,9,3,120,0
9,0,0,0,0,0,0,9,0
65,3,0,12,0,2,0,82,0
47,0,0,2,0,0,0,49,0
77,0,0,0,0,0,0,77,0
5,0,0,0,0,0,0,5,0
3,0,0,0,0,0,0,3,0
41,0,1,0,0,0,1,43,0
433,27,0,11,0,0,11,482,0
87,5,0,0,0,0,0,92,0
168,3,0,3,0,0,2,176,0
115,0,4,6,0,0,3,128,0
92,3,0,0,0,1,0,96,0
93,0,0,0,0,0,1,94,0
62,0,0,1,0,4,0,67,0
171,11,0,1,0,0,5,188,0
204,8,3,0,0,0,2,217,0
53,0,1,1,0,0,11,66,0
82,0,0,3,0,1,4,90,0
128,6,0,9,0,2,0,145,0
98,5,0,1,0,0,2,106,0
413,9,1,3,0,3,18,447,0
172,2,0,0,0,3,2,179,0
48,0,0,0,0,0,1,49,0
49,0,0,3,0,0,0,52,0
56,5,0,0,0,4,4,69,0
160,2,0,1,0,0,5,168,0
2,0,0,0,0,0,0,2,0
233,0,2,17,0,0,0,252,0
47,0,0,0,0,0,0,47,0
27,0,0,0,0,0,0,27,0
75,0,0,0,0,0,0,75,0
41,0,0,0,0,0,0,41,0
2,0,0,0,0,0,0,2,0
237,4,0,8,0,0,0,249,0
1,0,0,1,0,0,1,3,1
27,0,0,0,0,0,0,27,0
6,0,0,0,0,0,0,6,0
64,0,0,0,0,0,0,64,0
8,0,0,0,0,0,0,8,0
1,0,0,1,0,0,2,4,0
14,0,0,0,0,0,0,14,0
27,3,0,0,0,1,0,31,0
77,0,0,0,0,0,0,77,0
10,0,0,0,0,0,0,10,0
37,0,0,1,0,0,6,44,0
41,0,0,0,0,0,0,41,0
13,0,0,2,0,0,0,15,0
5,0,0,0,0,0,0,5,0
39,4,0,0,0,0,4,47,0
31,0,2,0,0,0,0,33,0
58,3,0,0,0,0,1,62,0
12,0,0,0,0,0,0,12,0
3,0,0,0,0,0,0,3,0
21,0,0,0,0,0,0,21,0
0,1,0,0,0,0,0,1,0
61,0,0,2,0,1,1,65,0
3,0,0,0,0,0,0,3,0
4,0,0,0,0,0,0,4,0
42,0,0,3,0,1,0,46,0
12,0,0,0,0,0,0,12,0
34,0,0,0,0,5,1,40,0
26,0,0,0,0,0,0,26,0
1,0,0,0,0,0,0,1,0
11,0,0,0,0,0,0,11,0
87,0,0,0,0,0,0,87,0
184,0,0,5,0,2,0,191,0
28,0,0,0,0,0,0,28,0
23,0,0,0,0,0,0,23,0
5,0,0,0,0,0,0,5,0
21,0,0,0,0,0,1,22,1
17,0,0,0,0,0,0,17,0
90,0,1,3,0,1,1,96,1
143,0,0,4,0,0,0,147,0
269,0,1,0,0,0,5,275,0
47,0,0,8,0,0,1,56,1
60,0,0,1,0,8,0,69,0
122,7,0,2,0,11,3,145,0
119,0,1,2,0,0,1,123,0
91,4,0,2,0,0,0,97,0
98,3,1,0,0,1,2,105,1
211,14,0,0,0,11,5,241,0
75,5,0,0,0,4,1,85,1
121,12,0,0,0,3,2,138,0
68,22,0,1,0,37,19,147,0
91,0,0,3,0,0,0,94,0
29,0,0,8,0,0,0,37,0
80,0,0,1,0,0,0,81,0
71,3,1,0,0,0,6,81,0
53,10,0,0,0,0,1,64,1
149,59,0,0,0,42,18,268,0
37,0,0,0,0,0,0,37,0
60,13,0,0,0,0,0,73,0
100,0,0,1,0,6,4,111,0
60,3,0,0,0,0,3,66,0
54,0,0,0,0,1,0,55,0
81,1,0,2,0,0,5,89,1
78,0,0,0,0,0,0,78,0
90,6,1,0,0,1,0,98,0
81,6,0,0,0,0,0,87,0
82,1,0,0,0,8,3,94,0
192,1,0,0,0,5,3,201,0
66,85,0,8,0,5,17,181,0
222,22,1,1,0,1,8,255,1
42,11,4,0,0,0,0,57,0
41,12,0,0,0,1,3,57,0
67,4,0,3,0,0,6,80,0
98,0,0,0,0,0,0,98,0
92,6,0,0,0,4,7,109,0
21,0,0,0,0,0,0,21,0
111,19,0,0,0,0,2,132,0
110,25,2,0,0,12,14,163,0
34,0,0,0,0,11,0,45,0
31,1,0,0,0,5,0,37,1
31,0,0,0,0,3,3,37,0
289,47,7,3,0,136,30,512,0
192,26,0,5,0,72,15,310,0
110,0,0,0,0,6,0,116,0
32,0,0,0,0,0,5,37,0
22,0,0,0,0,0,0,22,0
28,0,0,0,0,2,1,31,0
35,3,1,0,0,15,0,54,0
19,0,0,0,0,0,3,22,0
53,2,0,0,0,0,0,55,0
75,0,0,0,0,12,2,89,0
60,0,0,1,0,0,1,62,0
25,2,1,1,0,3,3,35,1
25,7,0,0,0,11,0,43,0
27,0,0,0,0,0,0,27,0
14,3,0,0,0,0,0,17,0
102,11,1,15,0,17,4,150,0
37,5,0,0,0,7,4,53,0
43,0,0,0,0,6,2,51,0
89,8,0,1,0,15,6,119,0
41,8,0,2,0,15,0,66,0
48,6,0,0,0,6,0,60,0
41,2,0,0,0,3,1,47,0
37,1,1,0,0,2,0,41,0
28,2,0,0,0,5,0,35,0
36,0,0,0,0,0,0,36,0
64,5,0,3,0,1,5,78,0
50,3,0,1,0,3,0,57,0
24,0,0,0,0,1,0,25,1
35,0,1,0,0,3,1,40,0
37,5,3,0,0,0,0,45,0
43,2,0,0,0,0,0,45,0
64,2,0,0,0,0,0,66,0
54,0,0,2,0,12,0,68,0
39,0,0,0,0,0,10,49,0
55,0,0,0,0,0,3,58,0
43,3,0,0,0,7,0,53,0
57,0,0,0,0,6,5,68,0
48,0,0,0,0,18,0,66,0
95,13,2,0,0,18,0,128,0
56,0,0,1,0,0,0,57,0
90,6,1,0,0,23,1,121,1
135,8,1,0,0,4,0,148,0
69,4,0,0,0,3,2,78,0
92,2,0,0,0,4,2,100,0
79,0,0,0,0,17,6,102,0
57,1,0,0,0,0,0,58,0
61,2,0,0,0,7,0,70,0
4,0,0,0,0,0,0,4,0
13,4,0,0,0,0,3,20,0
2,0,0,0,0,0,0,2,0
4,0,0,0,0,0,0,4,0
4,0,0,0,0,0,0,4,0
165,8,0,3,0,8,3,187,0
62,8,0,8,0,0,0,78,0
43,12,0,0,0,1,0,56,0
180,17,1,3,0,19,12,232,1
6,2,0,0,0,0,0,8,0
268,219,4,18,0,49,34,592,0
63,0,0,0,0,0,0,63,0
13,20,0,0,0,32,3,68,0
3,12,0,9,0,0,2,26,0
86,0,0,0,0,1,4,91,0
47,2,0,8,0,0,6,63,0
4,0,0,0,0,4,0,8,0
315,61,2,0,0,153,32,563,0
6,0,0,0,0,20,0,26,0
7,2,0,0,0,0,6,15,0
20,1,0,0,0,22,0,43,0
8,2,0,0,0,16,0,26,0
365,48,1,0,0,5,8,427,0
71,4,0,0,0,9,11,95,0
35,1,0,0,0,0,2,38,0
471,34,1,17,0,13,21,557,0
62,10,0,0,0,13,0,85,0
84,3,0,6,1,0,7,101,0
94,0,0,1,0,1,1,97,0
60,12,0,0,0,0,2,74,0
47,9,0,0,0,0,2,58,0
70,12,0,7,0,0,0,89,0
29,0,0,1,0,5,0,35,0
338,21,0,14,0,4,9,386,0
124,10,0,1,0,0,6,141,1
21,0,0,0,0,5,0,26,0
16,0,0,0,0,0,0,16,0
2,0,0,0,0,0,0,2,0
8,0,0,0,0,0,0,8,0
197,14,0,0,1,1,1,214,0
62,0,0,0,0,0,0,62,0
99,8,0,0,0,5,1,113,0
101,19,1,1,0,4,3,129,0
59,11,0,0,0,0,0,70,0
19,2,0,1,0,0,1,23,0
21,3,0,1,0,0,3,28,0
298,17,1,7,0,51,14,388,0
32,10,0,1,0,7,5,55,0
34,14,0,0,0,13,0,61,0
28,9,0,0,0,0,0,37,0
38,2,0,0,0,2,0,42,0
29,0,0,0,0,0,0,29,0
77,3,0,10,0,0,6,96,0
269,119,5,4,0,166,12,575,0
106,17,1,0,0,0,13,137,0
64,19,0,0,0,38,7,128,0
16,2,0,0,0,0,0,18,0
25,0,0,0,0,0,0,25,0
33,0,0,0,0,0,0,33,0
27,0,0,0,0,0,0,27,0
4,0,0,0,0,0,0,4,0
56,2,0,1,0,0,2,61,0
151,45,0,4,0,11,9,220,0
24,0,0,0,0,4,3,31,0
20,0,0,0,0,0,0,20,0
30,0,0,0,0,0,0,30,0
270,6,0,17,0,1,4,298,0
30,0,0,2,0,0,0,32,0
14,0,0,0,0,0,0,14,0
81,0,0,3,0,5,0,89,0
201,8,0,5,0,0,1,215,0
64,0,0,0,0,4,1,69,0
8,0,0,0,0,0,0,8,0
95,3,0,14,0,0,2,114,0
85,0,0,9,0,0,0,94,0
279,16,0,33,0,0,4,332,0
306,10,0,30,0,2,14,362,0
131,0,1,8,0,0,9,149,0
3,0,0,0,0,0,0,3,0
53,8,0,0,0,8,4,73,0
126,17,0,1,0,1,5,150,1
1,0,0,0,0,0,0,1,0
120,11,1,8,0,3,4,147,0
22,1,0,0,0,0,0,23,0
24,5,0,0,0,1,4,34,0
25,1,0,0,0,0,0,26,0
41,0,0,0,0,0,2,43,0
1,0,0,0,0,0,0,1,0
40,4,0,0,0,0,0,44,0
262,47,0,14,0,16,8,347,0
33,4,0,10,0,4,5,56,0
33,5,0,0,0,10,0,48,0
4,1,0,0,0,0,0,5,0
38,13,0,0,0,0,2,53,0
196,8,0,3,0,17,5,229,0
93,11,0,3,0,0,3,110,0
59,4,0,0,0,13,6,82,0
5,0,0,0,0,0,0,5,0
10,0,0,0,0,0,0,10,0
13,0,0,0,0,0,0,13,0
22,11,0,0,0,1,1,35,1
1,0,0,0,0,0,0,1,0
19,0,0,0,0,10,0,29,0
46,0,0,0,0,0,0,46,0
372,42,1,27,0,10,12,464,0
45,11,0,0,0,0,0,56,0
84,14,1,0,0,0,0,99,0
39,1,0,0,0,1,1,42,0
72,0,0,0,0,0,0,72,0
34,3,0,1,1,0,0,39,0
57,0,0,0,0,25,1,83,0
342,32,2,14,2,28,20,440,0
244,16,0,0,0,5,5,270,0
94,19,0,0,0,8,3,124,0
157,31,0,7,0,9,6,210,0
74,8,2,4,0,1,3,92,0
4,0,0,0,0,0,0,4,0
112,10,0,4,0,1,0,127,0
44,1,0,0,0,1,0,46,0
35,0,0,0,0,7,0,42,0
13,0,0,0,0,4,0,17,0
142,7,1,1,0,0,1,152,1
30,0,0,0,0,6,0,36,0
43,3,0,0,0,0,1,47,0
88,1,2,0,0,0,7,98,0
84,0,0,0,0,0,0,84,0
121,3,2,0,0,0,0,126,0
69,11,0,0,0,0,1,81,0
64,2,3,0,0,0,1,70,0
17,0,0,0,0,0,0,17,0
1,0,0,1,0,0,1,3,0
78,5,1,0,0,14,1,99,1
86,0,0,3,0,0,1,90,0
91,0,0,0,0,0,0,91,0
78,2,0,0,0,0,1,81,0
90,0,0,0,0,2,0,92,0
50,0,0,0,0,0,2,52,0
67,0,1,0,0,0,0,68,0
60,0,0,0,0,0,3,63,0
89,0,1,0,0,0,0,90,0
66,1,0,0,0,0,0,67,0
309,41,0,30,0,88,14,482,0
50,2,0,0,0,0,3,55,0
759,110,5,41,0,148,48,1111,0
36,4,0,0,0,0,0,40,0
29,0,0,0,0,11,0,40,0
95,17,0,3,0,34,4,153,0
6,2,0,2,0,0,0,10,0
31,9,0,0,0,18,6,64,0
73,6,0,12,0,0,0,91,0
6,0,0,0,0,0,0,6,0
51,15,0,14,0,3,3,86,0
112,12,0,2,0,20,7,153,0
110,26,2,15,2,9,9,173,0
11,0,0,0,0,6,0,17,0
22,3,0,0,0,30,2,57,0
81,7,0,7,0,0,1,96,0
39,0,0,0,0,0,0,39,0
20,3,0,0,0,0,0,23,0
32,5,3,0,0,11,0,51,0
26,1,0,0,0,6,0,33,0
41,12,0,3,0,13,3,72,0
7,0,0,0,0,0,0,7,0
92,12,3,5,0,1,1,114,0
56,2,0,0,0,2,0,60,0
4,0,0,0,0,0,0,4,0
12,3,0,0,0,0,0,15,0
12,0,0,0,0,0,0,12,0
7,0,0,0,0,0,0,7,0
100,23,0,6,0,45,11,185,0
27,16,0,1,0,3,4,51,0
32,4,0,4,0,1,0,41,0
16,0,0,0,0,0,0,16,0
4,0,0,0,0,0,0,4,0
4,0,0,0,0,0,0,4,0
76,0,0,5,1,10,5,97,0
116,13,0,26,0,9,8,172,0
73,1,0,7,0,0,2,83,0
135,9,0,10,0,0,8,162,0
60,0,0,0,0,0,0,60,0
2,0,0,0,0,0,0,2,0
80,6,0,0,0,0,12,98,0
71,10,0,10,0,2,5,98,0
91,24,0,2,0,0,5,122,0
34,0,0,0,0,0,0,34,0
86,16,0,2,0,5,0,109,0
91,6,0,8,0,5,0,110,0
28,0,0,1,0,0,0,29,0
21,0,0,1,0,0,2,24,0
1,0,0,0,0,0,0,1,1
6,0,0,0,0,0,0,6,0
1,0,0,0,0,0,0,1,0
0,1,0,0,0,0,0,1,0
6,0,0,0,0,0,0,6,0
2,0,0,0,0,0,2,4,0
98,14,0,0,0,0,2,114,0
497,35,6,42,0,36,25,641,0
136,28,0,18,1,23,11,217,1
60,8,0,9,0,0,0,77,0
194,20,0,10,0,1,14,239,0
34,6,0,4,0,0,2,46,0
85,6,0,7,0,1,3,102,1
4,0,0,0,0,0,0,4,0
103,0,1,9,0,0,8,121,0
7,0,0,0,0,0,4,11,0
3,0,0,0,0,0,1,4,0
84,4,0,19,0,0,5,112,0
109,15,0,0,4,0,0,128,0
55,4,0,1,0,0,1,61,0
3,0,0,2,0,0,0,5,0
74,1,0,5,0,0,0,80,1
28,0,0,0,0,0,0,28,0
38,2,0,0,0,0,0,40,0
10,0,0,0,0,0,0,10,0
49,2,0,0,0,0,3,54,0
2,0,0,0,0,0,0,2,0
45,0,0,4,0,0,0,49,0
57,0,0,0,0,0,0,57,0
11,0,0,0,0,2,0,13,0
282,27,1,6,0,12,6,334,1
98,9,0,1,0,1,3,112,1
115,16,6,1,0,18,3,159,0
80,10,0,0,0,0,8,98,0
74,0,0,0,0,0,3,77,0
600,145,1,28,0,28,59,861,0
16,5,0,0,0,0,1,22,0
68,22,0,0,0,20,4,114,0
10,3,0,1,0,1,0,15,0
6,0,0,0,0,0,0,6,0
18,7,0,0,0,2,0,27,0
57,6,0,0,0,12,6,81,0
19,12,0,1,0,1,3,36,1
38,10,0,1,0,6,3,58,0
19,4,0,0,0,0,0,23,0
165,69,3,0,0,38,26,301,0
3,1,0,0,0,0,0,4,0
131,53,1,0,0,8,9,202,0
6,0,0,1,0,0,0,7,0
86,13,0,2,0,6,4,111,0
88,6,0,1,0,0,1,96,0
20,2,0,0,0,0,0,22,0
39,4,0,1,0,0,8,52,0
49,5,0,0,0,0,12,66,0
62,14,0,1,0,0,12,89,0
51,15,0,0,0,0,9,75,0
25,3,4,0,0,1,4,37,0
56,5,1,0,0,6,2,70,1
35,4,0,2,0,0,0,41,0
113,2,0,11,0,9,1,136,0
30,0,0,0,0,0,0,30,0
4,0,0,0,0,0,0,4,0
4,0,0,0,0,0,0,4,0
11,0,0,0,0,0,0,11,0
2,0,0,0,0,0,0,2,0
71,1,4,1,0,0,5,82,0
31,0,0,0,0,0,0,31,0
14,0,0,0,0,0,0,14,0
34,0,0,0,0,0,0,34,0
124,0,0,0,0,5,5,134,0
57,0,0,2,0,0,0,59,0
153,0,0,0,0,0,0,153,0
10,0,0,0,0,0,0,10,0
21,0,0,0,0,0,0,21,0
26,0,0,0,0,0,0,26,0
4,0,0,0,0,0,0,4,0
54,27,0,0,0,11,10,102,0
50,8,1,4,0,13,5,81,0
14,12,3,0,0,1,0,30,0
64,5,4,1,0,10,2,86,0
39,22,0,0,0,0,1,62,1
37,19,2,0,0,11,8,77,0
59,9,0,0,0,11,2,81,0
17,6,0,0,0,10,0,33,0
14,0,0,0,0,0,0,14,0
310,78,0,14,0,20,21,443,0
57,5,0,0,0,6,0,68,0
40,2,0,0,0,0,5,47,0
48,3,0,6,0,7,2,66,0
87,14,1,0,0,5,1,108,2
383,52,3,11,0,19,25,493,0
1,3,0,0,0,0,0,4,0
34,0,0,0,0,0,2,36,0
88,12,1,2,0,0,6,109,0
149,26,0,2,0,11,6,194,0
52,0,0,0,0,1,0,53,0
121,6,0,1,0,1,3,132,0
18,4,0,0,3,0,0,25,0
216,15,0,0,0,10,0,241,0
30,4,0,0,0,0,0,34,0
193,49,2,8,0,4,6,262,0
51,0,0,0,0,0,0,51,0
25,0,0,9,0,0,0,34,0
7,0,0,0,0,0,0,7,0
3,0,0,0,0,0,0,3,0
90,7,0,1,0,2,4,104,0
122,5,0,0,0,3,5,135,0
234,5,1,1,0,12,3,256,0
74,1,1,1,0,0,2,79,0
37,2,0,0,0,0,0,39,0
22,0,0,3,0,0,0,25,0
23,0,0,0,0,0,0,23,0
27,0,0,1,0,0,2,30,0
34,0,0,0,0,0,0,34,0
69,4,1,0,0,2,0,76,0
149,4,0,0,0,6,4,163,0
69,3,0,0,0,7,0,79,0
61,4,0,0,0,0,0,65,0
52,0,0,0,0,0,0,52,0
105,4,0,4,0,3,0,116,0
106,4,0,0,0,8,0,118,0
39,1,0,0,0,0,0,40,0
85,1,0,0,0,5,0,91,0
45,0,0,0,0,3,0,48,0
16,0,0,0,0,0,0,16,0
105,15,0,15,0,8,2,145,0
71,6,0,0,0,0,0,77,0
108,0,0,2,0,5,1,116,0
49,1,0,1,0,16,1,68,0
6,0,0,0,0,0,0,6,0
22,1,0,0,0,0,0,23,0
45,2,0,0,0,1,5,53,0
40,2,0,2,0,1,0,45,0
123,0,1,5,0,0,1,130,0
23,0,0,0,0,0,0,23,0
10,0,0,0,0,0,5,15,0
16,0,0,0,0,2,1,19,1
6,0,0,0,0,0,0,6,0
100,0,0,0,0,0,9,109,0
2,0,0,0,0,0,1,3,0
3,0,0,0,0,0,0,3,0
107,5,0,1,0,1,12,126,0
44,4,0,0,0,0,2,50,0
54,0,0,0,0,2,0,56,0
20,1,0,0,0,0,0,21,0
25,0,0,0,0,0,0,25,0
7,1,0,0,0,0,3,11,0
67,0,0,0,0,0,0,67,0
98,0,0,0,0,0,0,98,0
109,1,1,1,0,4,1,117,0
56,1,0,0,0,0,3,60,0
44,0,0,0,0,0,0,44,0
287,14,1,0,0,5,8,315,0
0,3,0,0,0,0,1,4,0
69,4,0,2,0,0,5,80,0
45,1,0,0,0,4,0,50,1
179,33,1,33,0,0,8,254,0
0,7,0,0,0,0,0,7,0
13,20,0,16,0,4,4,57,0
53,23,1,14,0,5,7,103,1
72,28,0,13,0,9,8,130,0
9,2,0,6,0,0,0,17,0
19,0,0,0,0,0,0,19,0
25,0,0,0,0,0,0,25,0
30,3,0,0,0,0,0,33,0
438,91,10,9,0,332,38,918,0
20,2,0,0,0,21,0,43,0
25,7,0,0,6,22,11,71,0
43,6,0,0,0,8,1,58,1
19,5,0,0,0,8,2,34,0
19,2,0,1,0,20,1,43,0
19,0,0,0,0,0,0,19,0
12,6,0,0,0,0,0,18,0
36,17,0,2,0,18,0,73,0
62,17,0,0,0,44,6,129,0
201,19,0,6,0,5,0,231,0
112,10,0,1,0,6,3,132,0
47,1,0,0,0,10,1,59,0
36,1,0,0,0,1,2,40,0
220,7,0,3,0,3,14,247,0
106,7,0,1,0,1,4,119,0
102,8,0,11,0,0,0,121,0
80,0,0,0,0,0,13,93,0
48,2,0,7,0,0,7,64,0
6,0,0,0,0,0,0,6,0
4,0,0,1,0,0,0,5,0
36,7,0,1,0,15,5,64,0
274,44,0,7,0,44,6,375,0
31,2,0,4,0,0,6,43,0
23,0,0,0,0,0,0,23,0
26,7,0,0,0,0,0,33,0
8,2,0,0,0,0,0,10,0
37,6,0,0,0,19,0,62,0
29,4,0,0,0,0,0,33,0
56,5,0,0,0,0,0,61,0
50,6,0,0,0,0,2,58,0
243,16,1,10,0,4,5,279,0
29,5,0,0,0,0,3,37,0
70,0,0,0,0,0,0,70,0
23,1,2,0,0,0,2,28,0
0,4,0,0,0,0,0,4,0
72,7,0,6,0,0,2,87,0
72,1,1,0,0,0,1,75,0
131,8,1,2,1,19,5,167,0
38,6,0,0,0,0,6,50,0
53,6,0,1,0,3,0,63,0
42,0,0,2,0,0,1,45,0
101,7,0,0,0,3,0,111,0
24,1,0,0,0,5,0,30,0
146,7,0,0,0,3,5,161,0
57,2,0,1,0,0,1,61,0
26,0,0,0,0,0,0,26,0
54,8,0,0,0,21,1,84,0
24,10,0,0,0,1,4,39,0
159,7,0,2,0,0,1,169,0
44,1,0,0,0,0,1,46,0
83,0,0,7,0,8,0,98,0
140,4,0,1,0,0,5,150,0
741,180,6,65,0,168,53,1213,0
2,0,0,0,1,7,0,10,0
14,2,0,13,0,32,10,71,0
40,8,0,0,0,7,4,59,0
62,3,0,4,0,37,9,115,0
59,10,0,0,0,41,10,120,0
71,17,2,0,0,21,3,114,0
15,0,0,5,0,11,0,31,0
124,7,3,6,0,315,28,483,0
38,14,0,0,0,3,2,57,0
125,15,4,1,0,28,6,179,1
53,11,0,4,0,18,2,88,0
36,11,0,0,0,0,0,47,0
22,5,0,0,0,10,0,37,0
301,73,0,7,0,42,8,431,0
89,6,0,0,0,4,2,101,0
43,5,0,0,0,7,0,55,0
15,3,0,0,0,0,0,18,0
140,46,2,3,0,11,9,211,0
53,19,0,2,0,4,0,78,0
115,6,0,0,0,14,6,141,0
61,11,0,0,0,9,7,88,0
46,3,0,6,0,0,6,61,0
65,21,0,0,0,6,11,103,0
149,252,3,13,0,181,16,614,0
37,6,0,0,0,12,1,56,1
23,2,0,0,0,26,0,51,0
0,16,0,4,0,0,0,20,0
19,5,0,0,0,3,0,27,0
5,0,0,0,0,4,0,9,0
39,2,1,0,0,2,0,44,0
44,3,0,0,0,0,4,51,0
92,10,1,0,0,2,0,105,1
55,0,0,0,0,8,1,64,0
344,20,0,3,0,27,23,417,0
158,16,0,5,0,9,0,188,0
39,1,0,0,0,8,5,53,0
33,14,0,3,0,5,1,56,1
61,5,0,3,0,5,0,74,0
19,3,0,0,0,10,2,34,0
821,101,0,32,0,115,38,1107,0
43,12,0,0,0,3,1,59,0
35,2,0,0,0,0,2,39,0
25,0,0,4,0,4,0,33,0
60,10,0,1,0,0,0,71,0
32,6,0,1,0,14,4,57,1
55,2,0,0,0,3,6,66,0
74,11,0,4,0,13,2,104,0
56,5,0,1,0,0,2,64,0
45,5,1,0,0,18,0,69,0
80,3,0,0,0,0,0,83,0
15,0,0,0,0,0,0,15,0
209,8,1,5,0,12,7,242,1
40,1,0,0,0,0,2,43,0
45,0,1,0,0,0,0,46,1
22,2,0,0,0,0,0,24,0
42,5,0,0,0,0,4,51,0
52,2,0,4,0,12,3,73,0
81,11,0,3,1,0,2,98,0
147,12,0,1,0,11,5,176,1
10,0,0,0,0,3,0,13,0
2,0,0,0,0,0,0,2,0
41,4,0,0,0,4,3,52,0
20,0,0,1,0,8,2,31,0
8,3,0,0,0,0,0,11,0
23,0,0,0,0,0,0,23,0
3,0,0,1,0,0,0,4,0
8,0,0,0,0,0,0,8,0
5,0,0,0,0,0,0,5,0
5,0,0,4,0,0,0,9,0
128,55,1,12,0,16,5,217,0
8,1,0,3,0,2,0,14,0
39,15,0,1,0,15,1,71,0
115,0,5,2,0,74,5,201,0
107,3,0,2,2,7,0,121,0
34,2,0,3,0,0,3,42,0
59,3,1,0,0,0,0,63,0
48,0,0,0,0,7,1,56,0
1,0,0,0,0,0,0,1,0
65,8,0,13,0,4,4,94,0
117,37,0,4,0,16,11,185,0
43,40,0,0,0,31,2,116,0
5,1,0,0,0,0,0,6,0
31,0,0,0,0,0,0,31,0
45,1,0,9,0,7,4,66,0
159,81,3,0,0,47,25,315,0
14,3,0,0,0,8,5,30,0
57,14,0,1,0,0,0,72,0
34,19,0,0,0,38,3,94,0
267,245,10,1,0,162,39,724,0
51,70,1,0,0,20,17,159,0
27,31,10,0,0,30,11,109,0
37,1,0,0,0,15,10,63,0
62,27,1,1,0,17,12,120,0
18,2,0,0,0,1,6,27,0
14,4,0,0,0,12,2,32,0
22,0,0,0,0,0,0,22,0
16,0,0,0,0,0,0,16,0
20,0,0,0,0,6,0,26,0
83,4,4,1,0,2,3,97,0
2,0,0,0,0,1,0,3,1
41,5,0,0,0,0,0,46,0
1,0,0,0,0,0,0,1,0
3,0,0,0,0,0,0,3,0
58,0,0,0,0,0,3,61,0
60,0,0,0,0,8,0,68,0
79,4,0,2,0,1,1,87,0
35,5,0,0,0,10,2,52,0
35,0,0,0,0,1,0,36,0
8,0,0,0,0,0,0,8,0
5,0,0,0,0,0,0,5,0
2,0,0,0,0,0,0,2,0
541,300,6,8,0,152,49,1056,0
1,1,0,0,0,0,2,4,0
34,6,0,1,0,16,0,57,0
3,0,0,0,0,0,0,3,0
17,0,0,0,0,0,0,17,0
0,0,0,3,0,0,0,3,0
0,0,0,0,0,0,2,2,0
13,5,0,2,0,5,6,31,0
11,1,0,0,0,0,7,19,0
1,0,0,0,0,0,0,1,0
3,0,0,0,0,0,0,3,0
58,0,1,0,0,0,0,59,0
27,0,0,0,0,0,0,27,0
6,4,0,0,0,0,2,12,0
29,0,0,0,0,25,2,56,0
6,2,0,0,0,17,0,25,0
35,0,0,0,0,22,0,57,0
32,0,2,0,0,14,1,49,0
15,0,0,0,0,22,0,37,0
0,6,0,0,0,0,1,7,1
16,0,0,0,0,0,0,16,0
18,0,0,0,0,0,0,18,0
19,0,0,0,0,0,0,19,0
16,0,0,0,0,0,1,17,0
37,1,0,0,0,0,3,41,0
69,1,0,0,0,0,1,71,1
21,2,1,0,0,0,0,24,0
43,2,0,0,0,0,1,46,0
13,0,0,0,0,0,0,13,0
21,0,0,0,0,7,0,28,0
12,0,0,0,0,0,0,12,0
2,0,0,0,0,0,0,2,0
40,0,0,0,6,0,0,46,0
48,6,0,0,0,0,0,54,0
48,10,0,0,0,0,0,58,0
49,6,0,0,0,0,1,56,1
26,0,0,0,0,12,0,38,0
35,0,0,0,0,0,0,35,0
47,2,0,5,0,0,1,55,0
65,0,0,0,0,0,0,65,0
16,0,0,1,0,0,3,20,0
9,0,0,0,0,0,0,9,0
20,3,0,2,0,0,0,25,0
0,1,0,0,0,0,0,1,0
2,0,0,0,0,0,0,2,0
0,1,0,0,0,0,0,1,0
15,0,0,0,0,0,3,18,0
77,10,0,0,0,0,2,89,0
15,0,0,0,0,0,0,15,0
7,0,0,1,0,0,2,10,0
196,85,0,65,4,154,30,534,0
63,0,1,1,0,0,1,66,1
17,0,0,1,0,0,0,18,0
2,0,0,0,0,0,0,2,0
125,7,0,17,0,1,5,155,0
2,0,0,0,0,0,0,2,0
26,0,0,3,0,1,0,30,0
54,5,0,10,0,0,1,70,0
6,5,0,5,0,0,0,16,0
2,0,0,0,0,0,0,2,0
64,14,0,1,0,0,3,82,1
24,1,0,0,0,0,0,25,0
55,0,0,6,0,0,0,61,0
47,2,0,1,0,0,0,50,0
130,23,0,0,0,15,6,174,0
45,0,0,0,0,0,4,49,0
7,0,0,8,0,0,0,15,0
9,0,0,1,0,0,2,12,0
2,0,0,0,0,0,0,2,0
24,0,0,0,0,0,0,24,0
49,4,0,0,0,0,0,53,0
46,0,0,1,0,0,3,50,0
171,1,0,11,0,3,0,186,0
35,0,0,0,0,0,0,35,0
19,1,0,4,0,0,0,24,0
23,0,0,4,0,0,0,27,0
53,1,0,1,0,0,0,55,1
108,6,0,6,0,0,0,120,0
6,0,0,0,0,0,0,6,0
53,0,0,7,0,0,2,62,0
38,5,0,1,0,0,0,44,0
37,2,0,0,0,0,0,39,0
121,5,0,5,0,0,4,135,0
47,0,0,0,0,0,0,47,0
75,4,0,7,0,3,0,89,0
85,4,2,7,0,0,4,102,0
13,0,0,0,0,0,0,13,0
18,1,0,0,0,0,0,19,0
47,0,0,0,0,0,0,47,0
14,3,0,0,0,0,0,17,0
102,1,0,0,0,0,6,109,1
36,2,0,0,0,0,0,38,0
25,0,0,0,0,0,0,25,0
73,4,0,0,0,0,1,78,0
45,0,0,1,0,0,1,47,1
47,5,0,2,0,0,0,54,0
3,0,0,0,0,0,0,3,0
24,0,0,0,0,2,0,26,0
50,1,0,12,0,0,0,63,0
0,2,0,0,0,0,0,2,0
51,17,0,10,0,0,2,80,0
32,0,0,19,0,0,0,51,0
3,0,0,0,0,0,0,3,0
33,0,0,0,0,0,0,33,0
27,0,0,9,0,0,0,36,0
37,0,0,5,0,0,0,42,0
2,0,0,0,0,0,0,2,0
10,0,0,0,0,0,0,10,0
2,0,0,0,0,0,0,2,0
395,63,0,78,1,13,23,573,0
8,0,0,0,0,0,0,8,0
20,0,0,0,0,0,0,20,0
11,0,0,0,0,0,0,11,0
8,0,0,0,0,0,0,8,0
149,27,4,8,0,0,8,196,0
54,1,0,1,0,0,2,58,1
53,3,0,1,0,0,0,57,0
10,1,0,0,0,1,0,12,0
62,10,0,1,0,1,6,80,1
50,1,0,10,0,0,0,61,0
130,0,1,2,0,7,0,140,0
225,47,1,37,0,32,13,355,0
42,17,0,13,0,8,0,80,0
12,3,0,0,0,9,0,24,0
11,6,0,0,0,19,0,36,0
37,20,0,8,0,51,6,122,0
8,3,0,0,0,0,0,11,0
32,3,0,0,0,0,0,35,0
23,4,0,1,0,0,3,31,0
23,2,0,0,0,0,0,25,0
29,0,0,0,0,0,0,29,0
16,0,0,0,0,0,0,16,0
20,0,0,0,0,0,0,20,0
2,0,0,0,0,0,0,2,0
28,0,0,0,0,0,0,28,0
3,0,0,0,0,0,0,3,0
49,0,0,4,0,9,2,64,0
55,0,0,0,0,2,1,58,0
49,0,2,0,0,0,0,51,0
14,1,0,0,0,0,4,19,0
7,0,0,2,0,0,0,9,0
2,0,0,0,0,0,0,2,0
118,17,0,7,0,44,15,201,0
115,0,0,3,0,1,9,128,0
2,0,0,0,0,0,0,2,0
56,7,0,0,0,0,1,64,1
18,0,0,0,0,0,0,18,0
8,0,0,0,0,0,0,8,0
15,0,0,0,0,0,0,15,0
3,0,0,0,0,0,0,3,0
24,3,0,0,0,0,0,27,0
59,0,0,0,0,0,0,59,0
2,0,0,0,0,0,0,2,0
34,2,0,0,0,0,0,36,0
20,1,0,0,0,0,1,22,0
69,20,0,4,0,0,5,98,0
40,1,0,4,0,0,0,45,0
177,41,0,0,0,0,3,221,0
43,0,0,0,0,0,0,43,0
209,186,3,2,0,7,21,428,0
57,13,0,0,0,1,0,71,0
148,3,0,0,0,0,1,152,0
195,507,1,7,9,22,50,791,1
36,1,0,7,0,0,0,44,1
37,10,0,0,0,0,0,47,0
75,4,0,0,0,0,2,81,0
40,10,0,2,0,13,0,65,0
99,1,0,5,0,13,1,119,0
113,1,0,4,0,0,2,120,1
94,9,0,0,0,5,0,108,0
97,3,0,0,0,15,4,119,0
67,0,1,5,0,16,4,93,1
75,3,0,0,0,5,8,91,0
56,13,0,0,0,7,2,78,0
60,5,0,0,0,0,0,65,0
39,1,3,0,0,7,1,51,1
137,16,0,3,0,6,8,170,0
35,2,0,0,0,6,4,47,0
137,15,0,5,0,6,3,166,0
38,0,0,0,0,0,0,38,0
28,0,0,0,0,0,0,28,0
33,3,0,0,0,10,0,46,0
30,0,0,0,0,0,0,30,0
25,0,1,0,0,0,0,26,0
72,5,1,6,0,11,0,95,0
116,77,8,3,0,70,26,300,0
4,5,0,0,0,26,0,35,0
21,3,1,1,0,25,1,52,1
82,33,3,5,0,39,15,177,0
12,15,0,0,0,5,3,35,0
11,6,1,0,0,10,1,29,0
17,6,7,0,0,21,3,54,0
25,20,0,0,0,15,0,60,0
14,2,6,0,0,23,0,45,0
20,4,0,0,0,0,0,24,0
53,11,0,4,0,0,2,70,0
168,83,0,9,0,69,13,342,0
15,0,0,0,0,5,3,23,0
26,7,0,0,0,5,4,42,0
46,1,0,0,0,0,5,52,1
75,6,0,1,0,0,2,84,0
6,14,0,1,0,0,0,21,0
9,13,0,2,0,0,0,24,0
61,111,0,9,0,0,7,188,0
39,31,0,0,0,16,0,86,0
117,160,0,5,17,26,23,348,0
44,7,0,0,0,6,0,57,0
53,4,1,0,0,10,5,73,0
51,0,0,0,0,20,0,71,0
20,27,0,5,0,0,0,52,0
22,32,0,0,0,0,10,64,0
7,4,1,1,0,0,5,18,0
31,15,0,5,0,0,8,59,0
119,11,1,6,0,57,25,219,1
155,434,2,5,44,9,56,705,0
76,14,1,10,0,11,6,118,0
85,12,0,7,0,5,7,116,0
35,0,0,5,0,4,0,44,0
35,2,0,3,0,14,0,54,0
48,0,0,0,0,10,2,60,0
65,3,0,3,0,0,0,71,0
20,0,0,0,0,0,0,20,0
59,7,0,0,0,0,0,66,0
127,6,0,13,0,0,3,149,0
159,2,0,8,0,6,2,177,0
34,0,0,0,0,5,0,39,0
32,2,0,0,0,0,0,34,0
21,0,0,0,0,0,0,21,0
42,7,0,0,0,0,3,52,0
144,1,0,5,0,11,3,164,0
28,0,0,0,0,0,0,28,0
27,0,0,0,0,5,0,32,0
73,3,1,4,0,0,4,85,0
71,3,2,2,0,9,1,88,1
17,8,0,1,0,0,2,28,1
67,10,1,0,0,3,0,81,0
117,24,0,0,0,0,4,145,0
187,20,0,6,0,3,2,218,0
25,2,0,0,0,0,0,27,0
23,0,1,0,0,17,0,41,0
98,12,0,1,0,1,10,122,0
77,11,0,2,0,0,0,90,0
46,16,0,6,0,0,0,68,0
137,24,0,44,0,23,1,229,0
79,6,0,0,0,48,2,135,0
122,2,4,0,0,9,8,145,0
55,9,0,0,0,5,4,73,0
206,27,0,8,0,15,15,271,0
161,22,0,1,0,1,4,189,0
65,0,1,7,0,0,5,78,0
69,11,0,16,0,5,2,103,0
73,21,0,10,0,0,5,109,0
35,0,0,0,0,0,0,35,0
68,0,0,5,0,1,0,74,0
44,2,0,0,0,5,0,51,0
86,1,0,0,0,0,2,89,0
71,5,0,0,0,0,0,76,0
122,2,0,2,0,0,0,126,0
184,34,1,3,0,13,1,236,0
76,5,0,11,0,0,6,98,0
67,14,0,11,0,2,5,99,0
12,7,0,0,0,0,0,19,0
30,10,0,0,0,3,8,51,0
28,4,0,0,0,2,6,40,0
27,17,0,0,0,0,1,45,0
22,7,0,2,1,5,0,37,0
24,0,0,6,0,0,0,30,0
38,0,0,0,0,0,0,38,0
24,0,0,6,0,0,0,30,0
56,8,0,0,0,1,6,71,0
66,13,0,6,0,1,0,86,0
94,17,0,0,0,0,0,111,0
45,3,1,3,0,0,4,56,0
47,3,0,1,0,0,0,51,0
101,40,1,8,0,7,5,162,0
51,12,0,0,0,5,3,71,0
250,38,2,0,0,15,19,324,0
26,13,0,0,0,3,0,42,0
48,0,0,0,0,0,0,48,0
33,0,0,0,0,0,0,33,0
67,7,0,0,0,0,8,82,0
50,0,0,0,0,5,0,55,0
1,0,0,1,0,0,1,3,0
6,8,0,0,0,0,0,14,0
168,38,0,1,0,6,2,215,0
170,8,0,0,0,4,2,184,0
149,13,3,1,0,0,7,173,0
0,0,0,0,0,1,0,1,0
48,14,0,0,0,4,2,68,0
225,16,0,7,0,6,14,268,0
16,3,0,0,0,0,0,19,0
7,0,0,0,0,0,2,9,0
160,5,0,1,0,4,2,172,0
95,6,0,0,0,0,0,101,0
87,0,0,1,0,2,6,96,0
94,4,0,1,0,0,2,101,0
1,0,0,0,0,1,0,2,1
9,0,0,0,0,0,0,9,0
2,0,0,0,0,0,1,3,0
105,7,1,0,0,0,4,117,0
70,9,0,18,0,0,4,101,0
67,4,0,2,0,0,6,79,0
54,10,0,0,0,0,0,64,0
48,3,0,1,0,0,0,52,0
135,11,0,11,0,27,8,192,0
9,0,0,0,0,0,0,9,0
54,17,0,0,0,4,0,75,0
24,6,0,0,0,0,4,34,0
53,17,0,8,0,3,0,81,0
31,0,0,0,0,0,0,31,0
48,0,0,0,0,0,0,48,0
69,9,0,0,0,0,0,78,0
39,11,0,3,0,0,0,53,0
63,0,0,5,0,2,2,72,0
73,0,0,12,0,0,0,85,0
84,8,0,0,0,0,3,95,0
18,0,0,0,0,0,0,18,0
9,0,0,0,0,0,0,9,0
8,0,0,0,0,0,0,8,0
20,0,1,1,0,0,0,22,0
2,0,0,0,0,0,0,2,0
62,3,1,0,0,1,5,72,0
237,36,6,0,0,10,2,291,0
59,13,0,0,0,0,2,74,0
65,8,0,0,0,2,0,75,0
76,0,0,0,0,0,0,76,0
73,3,0,0,0,0,4,80,0
69,2,0,0,0,1,1,73,1
109,10,0,0,0,7,6,132,0
61,15,2,0,0,0,5,83,0
53,1,1,0,0,0,2,57,0
122,24,2,0,0,0,3,151,0
32,5,0,0,0,0,0,37,0
56,2,0,4,0,0,1,63,0
164,1,0,0,0,0,5,170,0
47,0,0,1,0,0,0,48,0
49,3,0,4,0,0,0,56,0
96,0,0,1,0,0,0,97,0
89,0,0,0,0,0,0,89,0
45,7,1,0,0,0,0,53,0
69,0,0,0,0,0,0,69,0
61,0,0,0,0,0,0,61,0
32,0,1,0,0,0,0,33,0
31,0,0,0,0,0,0,31,0
60,0,0,0,0,0,1,61,0
47,0,0,0,0,2,1,50,0
41,0,0,0,0,0,0,41,0
1,0,0,0,0,0,0,1,0
44,2,0,0,0,0,2,48,0
5,0,0,0,0,0,0,5,0
4,0,0,0,0,0,0,4,0
23,8,0,0,0,0,0,31,0
55,14,0,0,1,1,0,71,0
2,0,0,0,0,0,1,3,0
74,0,0,0,0,6,0,80,0
39,0,0,0,0,0,0,39,0
17,4,0,0,0,0,0,21,0
43,11,0,0,0,0,0,54,0
28,1,0,0,0,0,1,30,0
67,0,0,0,0,0,2,69,0
82,0,0,0,0,0,0,82,0
37,0,0,1,0,0,1,39,1
82,0,0,0,0,0,3,85,0
53,0,0,0,0,0,1,54,0
51,0,0,0,0,0,3,54,0
15,0,0,0,0,0,2,17,0
162,37,1,7,0,12,12,231,1
14,0,0,0,0,0,0,14,0
49,26,0,6,0,0,7,88,0
145,34,0,14,0,0,7,200,0
5,0,0,0,0,0,0,5,0
25,0,0,0,0,0,0,25,0
13,0,0,0,0,0,1,14,0
47,0,0,0,0,0,0,47,0
12,0,0,0,0,0,0,12,0
87,28,0,0,0,0,2,117,0
72,0,0,0,0,1,0,73,0
53,0,0,0,0,0,3,56,0
91,78,0,4,0,3,5,181,0
34,3,0,0,0,0,0,37,0
48,4,0,0,0,0,0,52,0
236,2,1,0,0,9,3,251,1
5,0,0,0,0,0,1,6,0
38,8,6,4,0,15,5,76,0
33,1,0,0,0,0,0,34,0
248,94,3,10,0,27,16,398,0
31,4,0,0,0,7,0,42,0
73,32,0,7,0,1,8,121,1
19,0,0,6,0,0,0,25,0
32,5,0,0,0,0,0,37,0
24,3,0,0,0,0,5,32,0
161,39,2,15,0,24,8,249,0
24,4,0,0,0,0,0,28,0
37,14,0,8,0,0,0,59,0
16,9,0,0,0,0,2,27,0
17,10,0,0,0,0,0,27,0
212,105,3,25,0,1,25,371,0
96,25,0,4,0,0,3,128,0
148,0,0,2,0,0,1,151,0
17,0,0,0,0,0,0,17,0
83,0,0,0,0,5,1,89,1
23,1,0,0,0,0,0,24,0
13,0,0,4,0,0,0,17,0
15,0,0,0,0,0,1,16,0
2,0,0,0,0,0,0,2,0
11,0,0,0,0,0,0,11,0
15,0,0,0,0,0,0,15,0
9,0,0,0,0,0,0,9,0
15,0,0,0,0,0,0,15,0
4,4,0,0,0,0,0,8,0
2,0,0,0,0,0,1,3,1
0,2,0,0,0,0,0,2,0
69,0,0,0,0,0,0,69,0
1,1,0,0,0,0,3,5,1
125,2,0,0,0,0,1,128,0
99,1,1,0,0,0,2,103,0
4,0,0,0,0,0,0,4,0
414,192,1,0,0,1,0,608,0
424,186,2,62,0,2,30,706,0
52,0,0,0,0,0,1,53,1
10,0,0,0,0,0,0,10,0
85,2,3,0,0,0,4,94,0
7,0,0,0,0,0,0,7,0
102,0,0,0,0,0,0,102,0
74,9,0,0,0,0,1,84,0
9,0,0,0,0,0,0,9,0
171,0,4,0,0,2,0,177,0
101,2,0,1,0,0,0,104,0
70,0,0,0,0,1,2,73,0
133,147,2,7,0,25,26,340,0
85,28,2,2,0,10,4,131,0
1,0,0,0,0,0,1,2,0
42,20,0,0,0,10,5,77,0
51,3,0,0,0,0,0,54,0
437,24,0,23,0,10,12,506,0
53,2,0,1,0,2,0,58,0
20,0,0,0,0,0,0,20,0
275,39,0,4,0,4,2,324,0
37,10,0,0,0,0,0,47,0
7,0,0,0,0,0,0,7,0
44,8,0,0,0,7,2,61,0
32,0,0,0,0,8,0,40,0
66,12,0,0,0,0,0,78,0
2,0,0,0,0,0,0,2,0
6,0,0,0,0,0,0,6,0
0,0,0,1,0,0,0,1,0
170,105,3,11,0,99,22,410,0
65,79,1,1,4,44,7,201,0
17,15,0,0,0,9,4,45,0
96,12,0,0,0,13,6,127,0
123,968,4,8,2,8,38,1151,0
0,0,0,0,0,8,0,8,0
26,30,0,5,0,4,5,70,0
9,27,0,0,0,0,0,36,0
45,15,0,9,0,2,2,73,0
39,67,0,0,0,3,7,116,0
28,72,0,0,0,0,4,104,0
132,59,2,2,0,28,6,229,0
40,44,0,0,0,27,14,125,0
61,35,5,0,0,19,8,128,0
131,35,0,5,0,11,3,185,0
7,9,0,1,0,6,1,24,0
29,28,0,0,1,6,1,65,0
52,34,0,5,0,7,3,101,0
2,0,0,0,0,0,0,2,0
2,0,0,0,0,0,0,2,0
12,9,0,0,0,0,0,21,0
17,46,0,1,0,0,0,64,0
67,15,0,0,0,1,0,83,0
68,10,0,0,0,0,0,78,0
7,0,0,0,0,0,0,7,0
13,91,0,6,0,0,9,119,0
6,1,0,1,0,7,3,18,2
40,3,0,0,0,0,0,43,0
45,4,1,0,0,0,0,50,0
29,0,0,0,0,0,0,29,0
72,11,0,0,0,0,2,85,0
3,27,0,0,0,0,0,30,0
5,0,0,0,0,0,0,5,0
86,42,3,0,0,0,9,140,0
4,0,0,0,0,0,0,4,0
42,9,0,0,0,0,0,51,0
11,0,0,0,0,0,0,11,0
375,167,1,26,1,93,20,683,1
24,3,0,1,0,0,4,32,0
16,1,0,0,0,0,0,17,0
31,8,0,0,2,5,2,48,0
27,0,0,1,0,0,0,28,0
1,0,0,0,0,0,0,1,0
1,1,0,0,0,0,1,3,0
9,0,0,0,0,0,0,9,0
3,0,0,0,0,0,0,3,0
26,2,0,1,0,0,0,29,0
9,3,0,0,0,0,0,12,0
6,0,0,0,0,0,0,6,0
1,0,0,0,0,0,0,1,1
1,1,0,0,0,0,0,2,0
16,0,0,0,0,0,0,16,0
135,10,0,1,0,0,4,150,0
16,0,0,0,0,0,1,17,0
39,8,0,0,0,0,0,47,0
22,0,0,0,0,0,0,22,0
60,16,0,12,0,12,0,100,0
36,6,5,8,0,0,1,56,1
37,0,0,4,0,0,0,41,0
57,8,0,0,0,0,3,68,0
361,51,8,22,0,20,20,482,0
56,6,0,0,0,1,0,63,0
26,0,0,0,0,0,0,26,0
144,54,0,8,0,2,16,224,0
19,0,0,0,0,0,0,19,0
64,22,0,2,0,0,0,88,0
12,0,0,0,0,0,2,14,0
32,6,0,4,1,0,0,43,0
41,1,0,0,0,0,0,42,0
15,8,0,4,0,0,0,27,0
54,11,0,12,0,0,2,79,0
47,10,0,8,0,12,0,77,0
26,3,0,2,0,0,1,32,1
42,2,1,0,0,0,0,45,0
42,5,0,0,0,4,0,51,0
74,30,0,6,0,0,3,113,0
92,12,0,11,0,0,0,115,0
139,18,0,3,0,0,5,165,0
216,16,2,5,0,5,29,273,0
18,0,0,0,0,0,0,18,0
70,6,0,0,0,1,7,84,0
4,0,0,0,0,0,0,4,0
2,0,0,0,0,0,0,2,0
13,2,0,0,0,0,0,15,0
122,34,0,9,0,17,9,191,0
106,45,0,8,0,8,6,173,0
1,0,0,0,0,0,0,1,0
32,0,0,0,0,0,0,32,0
80,16,0,5,0,3,1,105,1
88,4,0,0,0,2,2,96,0
94,5,0,5,0,2,2,108,0
43,2,0,0,0,0,0,45,0
76,5,0,0,0,0,4,85,0
164,15,1,2,0,4,20,206,0
42,5,0,5,0,0,0,52,0
166,4,3,2,0,1,0,176,0
98,0,0,0,0,0,7,105,0
27,0,0,0,0,0,0,27,0
17,2,0,0,0,0,0,19,0
2,0,0,0,0,0,0,2,0
9,1,0,0,0,0,0,10,1
28,0,0,0,0,8,1,37,0
33,3,0,0,0,0,0,36,0
150,13,0,0,0,8,2,173,0
19,0,0,0,0,0,0,19,0
189,29,1,3,0,0,12,234,0
234,4,0,2,0,0,4,244,0
95,0,0,0,0,0,0,95,0
18,0,0,0,0,0,0,18,0
38,2,0,0,0,0,0,40,0
23,0,0,0,0,0,0,23,0
265,40,0,0,0,0,4,309,0
23,0,0,5,0,0,0,28,0
125,37,2,0,0,10,6,180,0
60,6,0,1,0,10,0,77,0
74,0,0,3,0,0,6,83,0
88,14,0,0,0,11,0,113,0
13,4,3,0,0,0,0,20,0
16,1,0,6,0,0,0,23,0
53,0,0,0,0,0,0,53,0
74,3,0,0,0,0,0,77,0
196,20,0,4,0,0,5,225,0
50,9,0,0,0,2,0,61,0
83,17,0,2,0,4,1,107,1
35,2,0,0,0,0,0,37,0
5,0,0,0,0,0,0,5,0
14,0,0,0,0,0,0,14,0
7,0,0,1,0,0,1,9,0
61,0,0,1,0,0,0,62,0
106,5,0,0,0,4,0,115,0
39,4,0,0,0,0,0,43,0
43,0,0,6,0,0,0,49,0
149,0,0,2,0,0,3,154,0
18,0,0,3,0,0,0,21,0
143,3,1,8,0,0,5,160,0
146,15,0,0,0,0,4,165,0
34,0,0,0,0,0,0,34,0
309,10,0,4,0,5,1,329,0
29,0,0,0,0,0,0,29,0
0,0,0,0,0,2,0,2,0
115,1,2,1,0,0,3,122,1
173,5,0,0,0,0,4,182,0
142,3,0,1,0,2,4,152,0
133,0,0,0,0,4,0,137,0
36,0,0,0,0,0,1,37,0
6,0,0,0,0,0,0,6,0
10,0,0,0,0,0,0,10,0
16,0,0,0,0,0,0,16,0
106,0,4,0,0,4,2,116,0
13,0,0,0,0,0,1,14,1
17,0,0,0,0,0,0,17,0
43,0,0,1,0,0,0,44,0
48,0,0,0,0,0,0,48,0
15,0,0,0,0,0,0,15,0
4,0,0,0,0,0,0,4,0
13,0,0,0,0,0,1,14,0
12,1,0,0,0,0,5,18,0
48,0,0,0,0,0,0,48,0
31,0,0,0,0,0,0,31,0
8,0,0,0,0,0,0,8,0
2,0,0,0,0,0,0,2,0
6,0,0,0,0,0,0,6,0
86,2,0,1,0,0,2,91,0
21,3,0,0,0,0,0,24,0
4,0,0,0,0,0,0,4,0
154,6,0,0,0,1,2,163,0
37,0,0,1,0,0,2,40,1
52,0,0,0,0,0,4,56,0
43,7,0,0,0,1,3,54,0
63,1,0,0,0,4,0,68,0
47,0,0,2,0,0,1,50,0
67,0,0,0,0,0,0,67,0
25,5,0,1,0,4,2,37,0
28,0,0,1,0,0,1,30,1
55,2,0,1,0,0,0,58,0
30,0,0,0,0,0,0,30,0
21,6,0,4,0,0,2,33,0
24,0,0,0,0,0,0,24,0
3,0,0,0,0,0,0,3,0
26,0,0,0,0,0,1,27,0
50,4,0,1,0,0,4,59,0
216,27,2,16,0,2,7,270,0
39,0,0,4,0,0,0,43,0
283,52,1,23,0,26,16,401,0
16,4,0,0,0,0,0,20,0
2,0,0,0,0,0,0,2,0
58,8,0,15,0,3,3,87,0
187,25,2,9,0,15,15,253,0
11,0,3,0,0,0,0,14,0
9,0,0,0,0,0,0,9,0
35,0,0,0,0,0,2,37,0
20,0,0,0,0,0,0,20,0
148,16,3,1,0,0,0,168,0
11,0,0,1,0,0,0,12,0
49,6,0,0,0,0,2,57,0
37,8,0,0,0,0,1,46,0
41,4,0,0,0,0,2,47,0
22,0,2,0,0,0,1,25,1
2,0,0,0,0,0,1,3,0
14,0,0,0,0,0,0,14,0
195,0,0,5,0,6,3,209,0
68,0,0,7,0,0,1,76,0
64,12,0,0,0,0,2,78,0
63,16,0,0,0,13,3,95,0
40,0,0,0,0,0,0,40,0
101,10,0,3,0,0,10,124,0
30,6,0,0,0,2,1,39,0
29,1,0,1,0,0,2,33,0
31,0,0,0,0,6,0,37,0
20,0,0,0,0,0,0,20,0
2,0,0,0,0,0,0,2,0
4,0,0,4,0,0,0,8,0
6,4,0,0,0,0,0,10,0
2,0,0,0,0,0,0,2,0
15,0,0,0,0,0,0,15,0
32,6,0,0,0,0,0,38,0
43,4,0,0,0,0,0,47,0
28,1,0,0,1,0,0,30,0
284,9,0,0,0,6,5,304,0
71,1,1,0,0,0,3,76,0
40,0,0,0,0,1,5,46,1
41,0,0,0,0,0,0,41,0
81,0,0,0,0,5,4,90,0
15,0,0,0,0,0,0,15,0
134,3,0,8,0,2,0,147,0
24,2,0,0,0,0,0,26,0
168,5,1,0,0,5,5,184,0
176,10,0,0,0,0,3,189,0
32,1,0,3,0,0,0,36,1
7,0,0,0,0,0,1,8,1
2,0,0,0,0,0,0,2,0
58,0,0,0,0,0,0,58,0
6,0,0,0,0,0,0,6,0
23,0,0,0,0,0,0,23,0
121,2,2,6,0,0,0,131,0
27,0,0,0,0,0,0,27,0
173,1,1,1,0,2,4,182,1
75,12,0,0,0,7,7,101,0
4,0,0,0,0,0,0,4,0
4,0,0,0,0,1,1,6,0
66,0,0,0,0,0,1,67,0
46,1,0,0,0,0,0,47,0
120,16,0,0,0,1,5,142,1
94,5,0,6,0,0,0,105,0
18,2,0,0,0,0,0,20,0
79,8,0,11,0,0,3,101,0
27,5,0,1,0,2,0,35,0
170,5,4,4,0,14,12,209,0
11,0,0,0,0,0,0,11,0
32,0,0,0,0,0,0,32,0
4,0,0,0,0,0,0,4,0
19,0,0,0,0,0,0,19,0
2,0,0,0,0,0,0,2,0
3,0,0,0,0,0,0,3,0
15,0,0,0,0,0,0,15,0
3,0,0,0,0,0,0,3,0
161,7,0,0,0,0,4,172,0
3,0,0,0,0,0,0,3,0
129,10,0,1,0,5,3,148,0
10,0,0,0,0,0,0,10,0
0,0,0,0,0,10,0,10,0
116,14,0,2,0,2,1,135,0
34,2,0,0,0,0,1,37,0
15,0,0,0,0,0,0,15,0
15,0,0,0,0,0,0,15,0
310,74,2,4,0,12,15,417,0
58,10,0,0,0,1,15,84,0
229,19,0,6,0,1,10,265,0
182,16,0,5,0,2,5,210,0
5,0,0,0,0,0,0,5,0
8,0,0,0,0,0,0,8,0
7,0,0,2,0,2,0,11,0
54,4,0,0,0,0,2,60,0
317,21,0,4,0,8,13,363,0
71,6,1,0,0,0,5,83,0
73,5,0,0,0,0,0,78,0
81,0,0,0,0,10,0,91,0
9,5,0,0,0,0,0,14,0
4,0,0,0,0,0,0,4,0
39,0,0,0,0,0,0,39,0
38,5,0,0,0,0,0,43,0
111,5,0,0,0,2,0,118,0
10,0,0,0,0,0,0,10,0
198,35,0,8,0,6,5,252,0
22,0,0,0,0,0,0,22,0
56,3,1,1,0,0,0,61,0
84,2,0,3,0,0,0,89,0
101,18,0,0,0,1,7,127,1
25,0,0,0,0,0,0,25,0
29,0,0,3,0,0,2,34,0
146,5,0,8,0,0,2,161,0
18,0,0,0,0,0,0,18,0
2,0,0,0,0,0,0,2,0
4,0,0,0,0,0,0,4,0
31,0,0,0,0,0,0,31,0
3,0,1,0,0,0,4,8,0
8,0,0,0,0,0,0,8,0
4,0,0,0,0,0,0,4,0
7,0,0,0,0,0,0,7,0
5,0,0,3,0,0,0,8,0
0,1,0,0,0,0,0,1,0
50,5,0,0,0,0,1,56,0
629,677,5,1,0,22,16,1350,0
11,0,0,0,0,0,2,13,0
11,0,0,0,0,0,0,11,0
82,3,0,2,0,0,2,89,0
118,0,2,3,0,2,6,131,0
9,0,0,0,0,0,0,9,0
15,0,0,0,0,0,0,15,0
48,1,0,0,0,1,0,50,0
82,1,0,0,0,0,3,86,0
75,3,0,0,0,0,0,78,0
18,0,0,0,0,0,1,19,0
21,0,0,0,0,0,0,21,0
34,0,0,0,0,3,0,37,0
61,0,0,1,0,0,5,67,1
238,6,0,4,0,1,7,256,0
30,1,0,0,0,0,0,31,0
8,0,0,0,0,0,0,8,0
112,0,1,2,0,2,3,120,0
4,0,0,1,0,0,0,5,0
4,0,0,0,0,0,0,4,0
63,0,0,1,0,0,3,67,0
112,0,0,0,0,0,0,112,0
74,0,0,1,0,0,0,75,0
31,0,0,1,0,2,2,36,1
111,0,0,2,0,1,0,114,0
104,0,0,3,0,0,3,110,0
12,0,0,0,0,0,0,12,0
70,0,0,2,0,0,4,76,0
61,0,0,0,0,0,0,61,0
28,0,0,0,0,0,0,28,0
17,0,0,0,0,0,0,17,0
36,0,0,0,0,0,0,36,0
106,1,0,1,0,0,1,109,1
1,0,0,0,0,0,0,1,0
8,0,0,1,0,0,0,9,0
86,4,0,0,0,0,1,91,0
86,0,0,3,0,0,0,89,0
75,0,0,0,0,0,3,78,0
80,0,0,2,0,0,0,82,0
40,0,0,0,0,0,0,40,0
27,0,0,0,0,0,0,27,0
37,0,0,0,0,0,0,37,0
78,1,0,1,0,0,0,80,0
235,2,0,4,0,0,2,243,0
4,0,0,1,0,1,0,6,0
66,0,0,0,0,0,0,66,0
14,0,0,0,0,0,0,14,0
18,0,0,0,0,0,0,18,0
17,0,0,0,0,0,0,17,0
25,0,0,0,0,0,0,25,0
79,13,1,2,0,0,1,96,0
28,5,0,5,0,1,1,40,0
16,1,0,0,0,2,1,20,0
34,0,0,0,0,0,0,34,0
32,0,0,3,0,0,0,35,0
27,0,0,4,0,0,0,31,0
42,0,0,0,0,0,0,42,0
76,3,0,2,0,0,3,84,0
41,0,0,0,0,0,0,41,0
63,5,0,0,0,0,1,69,0
103,0,0,1,0,5,0,109,0
97,5,0,0,0,0,3,105,0
37,0,1,0,0,1,0,39,0
63,1,0,0,0,0,3,67,1
25,0,0,0,0,0,1,26,0
51,0,0,0,0,3,1,55,1
64,4,0,2,0,0,2,72,0
104,0,0,1,0,0,0,105,0
21,0,0,0,0,0,0,21,0
75,1,0,0,0,0,6,82,1
132,2,0,1,0,0,4,139,0
91,8,1,3,0,0,1,104,1
155,1,0,2,0,10,9,177,0
70,0,0,0,0,0,1,71,0
58,2,0,2,0,0,1,63,0
57,2,0,0,0,4,3,66,0
57,0,0,2,0,0,5,64,0
61,0,0,0,0,0,0,61,0
34,1,0,1,0,0,0,36,0
41,0,0,0,0,0,0,41,0
74,0,0,0,0,1,0,75,1
49,0,2,0,0,0,0,51,0
57,0,0,0,0,0,0,57,0
63,1,0,0,0,0,0,64,1
95,3,1,3,0,0,4,106,0
130,0,0,0,2,0,2,134,0
99,3,1,1,0,0,2,106,1
45,0,0,0,0,0,0,45,0
70,0,0,3,0,1,0,74,0
44,1,0,0,0,0,0,45,1
40,0,0,0,0,0,0,40,0
23,0,0,0,0,0,0,23,0
38,0,0,2,0,0,1,41,0
65,0,0,0,0,0,0,65,0
71,0,0,0,0,0,0,71,0
55,1,0,0,0,2,0,58,0
44,1,0,2,0,0,0,47,0
71,1,0,0,0,0,1,73,2
41,3,0,1,0,0,0,45,0
42,1,0,0,0,0,2,45,0
42,0,0,2,0,0,0,44,0
31,0,0,0,0,0,0,31,0
49,0,0,0,0,0,0,49,0
108,0,0,0,0,2,0,110,0
39,1,0,0,0,0,1,41,0
64,0,0,0,0,0,0,64,0
29,0,0,1,0,1,0,31,1
38,1,0,0,0,0,0,39,0
37,1,1,0,0,0,1,40,0
43,0,0,0,0,0,0,43,0
56,1,0,0,0,0,0,57,0
126,0,0,2,0,1,3,132,0
270,13,0,4,0,6,12,305,0
164,2,0,3,0,0,0,169,0
1,0,0,0,0,0,0,1,1
8,41,0,0,0,0,0,49,0
7,19,0,0,0,0,1,27,1
22,73,0,2,0,0,1,98,0
50,113,2,0,0,0,3,168,0
5,60,1,0,0,1,6,73,0
1,49,0,1,0,0,0,51,0
11,14,0,0,0,4,0,29,0
33,35,0,0,0,0,1,69,1
32,30,1,0,0,0,5,68,1
26,5,0,2,0,0,0,33,0
2,31,0,0,0,6,1,40,0
6,166,0,1,0,0,8,181,0
6,81,0,4,0,0,6,97,0
0,73,0,9,0,0,0,82,0
1,54,0,8,0,0,0,63,0
8,76,0,1,0,0,0,85,0
17,82,0,3,0,0,3,105,0
3,15,0,0,0,0,0,18,0
13,9,0,0,0,0,0,22,0
1,24,0,2,0,0,0,27,0
14,62,1,0,0,0,1,78,0
43,327,1,4,0,1,10,386,1
10,18,0,6,0,0,0,34,0
7,62,0,0,0,0,2,71,0
12,85,0,0,0,0,5,102,0
0,94,0,0,0,0,1,95,0
6,121,0,0,0,2,2,131,0
31,328,7,21,0,0,22,409,0
8,35,0,7,0,1,0,51,0
11,28,0,9,0,2,2,52,0
13,84,0,14,0,6,4,121,0
12,24,0,2,0,0,0,38,0
15,31,0,0,0,0,0,46,0
22,36,0,11,0,0,7,76,0
25,30,1,18,0,0,0,74,0
38,29,0,31,0,1,5,104,0
65,180,1,2,0,3,5,256,0
15,0,0,0,0,0,1,16,1
46,3,0,0,0,0,1,50,0
34,13,0,0,0,2,5,54,0
25,7,0,4,0,0,2,38,0
18,24,0,1,0,1,2,46,1
17,17,0,0,0,0,5,39,0
36,30,0,1,0,0,7,74,0
20,1,0,0,0,0,0,21,1
6,1,0,0,0,0,0,7,0
51,7,0,0,0,0,0,58,0
31,0,0,3,0,0,0,34,0
26,22,0,13,0,0,12,73,0
23,5,0,3,0,0,0,31,0
4,0,0,8,0,0,0,12,0
14,8,0,0,0,0,0,22,0
22,29,1,0,0,1,0,53,0
24,32,0,1,0,0,1,58,0
25,37,0,0,0,0,0,62,0
35,38,0,3,0,0,0,76,0
14,27,0,4,0,0,2,47,0
29,27,0,0,0,0,1,57,1
8,9,0,0,0,0,0,17,0
26,14,0,19,0,6,3,68,0
17,24,0,0,0,0,4,45,0
30,5,3,2,0,19,11,70,0
40,38,0,4,0,0,6,88,0
40,24,0,16,1,10,6,97,0
39,9,0,0,0,3,0,51,0
24,22,0,0,0,0,1,47,0
45,15,0,0,0,43,10,113,0
15,0,0,0,0,11,0,26,0
8,0,4,0,0,7,0,19,0
2,0,0,0,0,2,7,11,0
13,9,0,2,0,20,0,44,0
48,25,1,0,0,21,1,96,0
8,2,0,0,0,13,0,23,0
7,0,0,0,0,13,0,20,0
1,1,0,0,0,8,7,17,0
90,327,0,23,0,5,16,461,0
4,23,0,0,0,0,1,28,0
7,67,0,5,0,0,5,84,0
18,58,0,0,0,0,0,76,0
41,80,1,20,0,54,16,212,0
7,8,0,0,0,8,0,23,0
60,141,1,3,0,29,16,250,1
36,89,1,0,0,1,20,147,2
14,81,0,0,0,0,7,102,0
9,105,0,0,0,2,2,118,0
9,153,0,0,0,0,1,163,0
11,49,1,0,0,6,1,68,0
39,96,1,0,0,0,2,138,0
133,91,0,0,1,1,0,226,0
5,0,0,0,0,0,0,5,0
0,1,0,0,0,0,0,1,0
220,244,6,1,0,16,33,520,0
20,44,0,0,0,8,0,72,0
13,64,0,0,0,1,0,78,0
18,10,0,0,0,0,0,28,0
1,1,0,0,0,0,0,2,0
47,6,0,0,0,0,7,60,0
58,17,0,0,0,0,3,78,0
30,8,0,0,0,0,0,38,0
18,13,0,0,0,0,0,31,0
33,18,0,0,0,0,7,58,0
65,0,0,0,0,0,0,65,0
3,0,0,0,0,0,0,3,0
92,12,1,0,0,0,0,105,0
73,8,0,0,0,3,6,90,0
72,13,0,0,0,0,1,86,1
30,1,0,0,0,0,0,31,1
95,1,0,1,0,0,2,99,0
142,0,0,0,0,0,2,144,0
35,0,0,0,0,0,0,35,0
300,10,0,0,0,10,6,326,0
4,0,0,0,3,0,0,7,0
111,2,0,0,0,0,2,115,0
291,0,0,0,0,0,0,291,0
2,0,0,0,0,0,0,2,0
29,0,0,0,0,0,0,29,0
0,1,0,0,0,0,0,1,1
0,2,0,0,0,0,0,2,0
18,57,1,0,0,3,3,82,1
20,63,1,1,0,0,4,89,0
19,67,0,0,0,0,1,87,0
9,72,0,0,0,0,8,89,0
19,0,0,0,0,0,0,19,0
36,107,0,3,0,6,9,161,0
37,63,0,1,0,0,7,108,0
104,4,0,1,0,10,6,125,0
50,157,0,0,0,1,17,225,0
14,149,0,0,0,0,6,169,0
34,153,1,0,0,0,1,189,1
65,37,0,1,0,3,4,110,0
31,75,12,0,0,0,7,125,0
7,34,0,0,0,0,4,45,0
11,149,0,1,0,0,16,177,0
70,10,0,0,0,0,2,82,0
47,6,0,0,0,2,1,56,1
0,1,0,0,0,0,1,2,1
38,81,0,2,0,0,5,126,0
31,42,2,1,0,0,2,78,0
51,43,0,0,0,0,4,98,0
39,75,2,0,0,11,3,130,0
12,73,0,0,0,0,0,85,0
0,68,0,0,0,1,0,69,0
5,48,0,4,0,0,0,57,0
0,20,0,0,0,0,2,22,0
22,41,0,0,0,0,0,63,0
29,74,0,0,0,2,7,112,0
11,85,0,0,0,2,2,100,0
2,29,0,0,0,0,0,31,0
0,54,0,0,0,0,4,58,0
4,56,0,0,0,0,2,62,0
34,250,1,0,0,3,17,305,0
2,33,0,0,0,0,0,35,0
2,88,0,0,0,1,0,91,1
4,87,0,0,0,0,0,91,0
5,60,0,0,0,3,0,68,0
9,110,0,0,0,1,0,120,0
9,160,0,0,0,6,9,184,0
0,1,0,0,0,0,0,1,0
8,38,0,0,0,0,0,46,0
21,72,0,3,0,0,0,96,0
3,11,0,0,0,0,0,14,0
13,74,0,5,0,0,0,92,0
8,47,1,0,0,0,1,57,0
3,63,0,0,0,1,0,67,0
23,109,0,0,0,0,1,133,0
15,33,0,0,0,0,0,48,0
21,66,0,0,0,0,4,91,0
8,57,0,0,0,0,0,65,0
23,37,0,0,0,0,1,61,0
20,49,0,4,0,4,0,77,0
3,49,0,0,0,0,3,55,0
16,81,0,0,0,0,4,101,0
4,35,0,0,0,5,3,47,0
13,61,0,0,0,7,0,81,0
24,44,1,0,0,0,1,70,0
1,71,1,0,0,0,6,79,0
9,80,0,1,0,0,5,95,0
6,41,0,2,0,0,7,56,0
69,0,0,0,0,0,9,78,0
27,0,0,0,0,0,0,27,0
0,0,0,1,0,0,0,1,1
41,0,0,0,0,0,0,41,0
51,16,1,0,0,0,3,71,0
4,0,0,0,0,0,0,4,0
98,0,0,0,0,0,2,100,0
119,3,0,0,0,0,1,123,0
101,0,0,6,0,2,2,111,0
63,0,0,0,0,1,0,64,0
101,1,0,0,0,5,4,111,0
76,0,0,1,0,11,0,88,0
92,0,1,0,0,0,3,96,0
74,0,0,0,0,0,0,74,0
108,1,0,0,0,4,0,113,0
13,0,0,0,0,0,1,14,0
18,1,0,0,0,0,0,19,0
39,0,0,0,0,0,0,39,0
72,3,0,1,0,1,4,81,0
66,0,0,0,0,0,0,66,0
39,1,0,0,0,0,0,40,1
15,6,0,0,0,0,0,21,0
19,0,0,4,0,0,0,23,0
20,0,1,0,0,0,0,21,0
28,0,0,0,0,0,1,29,0
239,0,0,4,0,1,8,252,0
19,0,0,0,0,0,0,19,0
35,0,0,0,0,0,0,35,0
52,0,0,0,0,0,3,55,0
87,0,0,0,0,0,5,92,0
32,3,0,0,0,0,0,35,0
27,0,0,0,0,0,0,27,0
34,0,1,0,0,0,2,37,1
52,1,0,0,0,0,0,53,0
52,3,0,0,0,0,0,55,0
26,6,0,0,0,0,0,32,0
15,0,0,0,0,5,0,20,0
163,1,1,0,0,0,1,166,1
89,2,1,0,0,0,3,95,0
131,0,0,0,0,0,1,132,0
20,0,0,0,0,0,0,20,0
115,0,0,0,0,0,0,115,0
81,7,0,0,0,0,0,88,0
110,0,0,0,0,1,2,113,0
34,0,0,0,0,0,4,38,0
34,1,0,0,0,0,0,35,0
159,8,2,0,0,3,0,172,0
23,0,0,2,0,0,0,25,0
21,0,1,0,0,0,0,22,0
14,0,0,0,0,1,3,18,0
44,3,1,0,0,0,0,48,0
63,3,0,0,0,0,2,68,0
14,0,0,0,0,0,0,14,0
20,3,0,2,0,0,0,25,0
29,0,0,0,0,0,0,29,0
25,0,0,4,0,0,0,29,0
57,26,4,0,0,0,17,104,0
20,16,0,0,0,0,0,36,0
69,1,0,0,0,0,0,70,1
61,0,0,0,0,0,0,61,0
17,10,0,0,0,0,1,28,1
290,184,2,11,0,0,10,497,0
5,34,0,0,0,0,1,40,0
33,4,0,0,0,0,0,37,0
7,13,0,0,0,0,0,20,0
25,2,0,0,0,0,0,27,0
39,62,0,4,0,9,0,114,0
182,178,0,2,0,7,7,376,0
29,68,0,8,0,0,8,113,0
9,7,0,0,0,0,2,18,0
67,0,0,0,0,0,3,70,0
5,0,0,0,0,0,0,5,0
17,5,0,0,0,0,0,22,0
20,0,0,0,0,0,1,21,1
16,0,0,0,0,0,1,17,1
12,0,0,0,0,1,0,13,0
12,0,2,0,1,0,0,15,0
21,0,0,0,0,0,0,21,0
13,0,0,0,0,0,0,13,0
37,0,0,0,0,0,0,37,0
7,0,0,0,0,0,0,7,0
11,0,0,0,0,0,0,11,0
9,0,0,0,0,3,1,13,0
19,4,0,0,0,0,0,23,0
7,0,0,0,0,0,0,7,0
13,0,0,0,0,0,1,14,0
57,33,0,0,0,1,9,100,0
146,13,0,0,0,1,0,160,0
429,288,2,1,1,17,55,793,0
35,0,0,0,0,0,0,35,0
52,10,0,0,0,1,1,64,0
79,2,0,0,0,0,1,82,1
32,0,0,0,0,0,1,33,0
74,0,0,0,0,0,0,74,0
60,7,0,1,0,0,3,71,0
13,3,0,0,0,3,4,23,0
2,2,0,0,0,0,0,4,0
2,0,0,0,0,0,1,3,0
263,6,1,2,0,6,8,286,0
51,6,0,0,0,2,6,65,0
38,3,0,0,0,0,0,41,0
53,0,0,0,0,0,0,53,0
28,0,0,0,0,0,0,28,0
111,19,0,0,0,0,4,134,0
95,13,0,0,0,0,4,112,0
236,6,0,12,0,0,6,260,0
28,0,0,0,0,0,0,28,0
1,0,0,0,0,0,0,1,0
67,5,0,0,0,0,1,73,1
24,13,0,0,0,0,0,37,0
8,0,0,0,0,0,0,8,0
11,12,0,0,0,0,0,23,0
46,1,0,1,0,9,1,58,1
85,8,0,5,0,0,4,102,0
27,8,0,0,0,0,0,35,0
10,0,0,0,0,0,0,10,0
62,0,0,0,0,0,0,62,0
1,0,0,0,0,0,0,1,1
12,0,0,0,0,0,0,12,0
44,0,0,0,0,0,1,45,0
90,0,0,0,0,6,0,96,0
204,18,0,0,0,0,6,228,0
50,13,0,2,0,0,0,65,0
45,0,0,0,0,0,0,45,0
7,3,0,0,0,0,0,10,0
31,0,0,1,0,0,0,32,0
42,0,0,0,1,0,2,45,0
47,8,0,0,0,0,0,55,0
228,12,3,1,0,0,2,246,0
57,3,2,0,0,0,4,66,0
62,1,0,0,0,0,0,63,0
147,2,1,0,0,0,4,154,0
60,0,0,0,0,0,0,60,0
58,18,0,0,0,0,0,76,0
16,2,0,1,0,0,0,19,0
16,3,0,2,0,0,0,21,0
34,0,0,0,0,0,1,35,0
90,24,0,0,0,0,1,115,0
52,7,0,0,0,0,0,59,0
74,30,0,1,0,0,0,105,0
90,21,0,0,0,0,5,116,0
321,73,1,5,0,6,15,421,0
100,48,0,5,0,0,9,162,0
37,6,0,0,0,7,0,50,0
80,8,0,0,0,0,2,90,0
104,45,0,0,0,4,4,157,0
16,1,0,0,0,0,0,17,1
17,3,0,0,0,0,0,20,0
169,6,2,15,0,0,3,195,0
85,2,1,1,0,4,9,102,1
65,2,0,0,0,1,7,75,0
8,0,0,0,0,2,0,10,0
46,0,0,7,0,0,1,54,0
15,0,0,0,0,0,0,15,0
34,0,0,0,0,0,0,34,0
109,12,0,0,0,3,1,125,0
73,0,0,0,0,0,0,73,0
67,0,0,0,0,0,0,67,0
128,11,0,0,0,0,3,142,0
121,7,0,1,0,4,2,135,1
25,0,0,0,0,0,0,25,0
162,2,0,0,0,0,4,168,0
94,0,3,0,0,0,2,99,0
46,2,0,0,0,0,1,49,0
43,12,0,0,0,5,2,62,0
70,0,0,0,0,0,0,70,0
47,0,0,0,0,0,3,50,0
54,0,0,1,0,0,1,56,0
72,0,1,0,0,0,2,75,0
77,6,0,0,0,0,0,83,0
37,1,0,2,0,0,0,40,0
71,0,0,0,0,0,0,71,0
111,3,0,0,0,0,0,114,0
74,0,0,0,0,0,8,82,0
48,0,0,0,0,0,0,48,0
75,0,0,0,0,0,0,75,0
86,6,0,2,0,0,2,96,0
50,3,0,0,0,0,0,53,0
76,0,0,1,0,0,0,77,0
64,1,0,0,0,0,1,66,0
73,1,0,0,0,0,2,76,0
71,0,0,0,0,0,0,71,0
65,1,0,5,0,0,5,76,0
29,11,0,0,0,0,2,42,0
90,0,0,0,0,0,3,93,0
104,6,0,1,0,0,0,111,0
95,7,0,0,0,0,0,102,0
95,0,1,0,0,0,0,96,0
102,2,0,0,0,0,7,111,0
93,9,0,1,0,0,1,104,0
91,12,0,6,0,0,5,114,0
98,1,0,8,0,1,6,114,0
58,4,0,0,0,0,4,66,0
78,6,0,6,0,0,0,90,0
70,10,0,3,0,1,1,85,0
77,5,0,3,0,0,3,88,0
94,2,0,1,0,0,5,102,1
66,0,1,0,0,0,1,68,0
68,4,0,1,0,0,0,73,0
60,4,0,6,0,0,4,74,0
62,6,0,2,0,0,1,71,0
40,4,0,6,0,0,0,50,0
73,0,0,4,0,0,0,77,0
90,3,0,0,0,0,1,94,0
39,0,0,0,0,0,0,39,0
135,0,1,1,0,1,3,141,0
18,0,0,0,0,0,0,18,0
2,0,0,0,0,0,1,3,0
72,5,0,0,0,0,6,83,0
74,2,0,0,0,0,0,76,0
70,1,0,1,0,0,1,73,1
156,13,0,1,0,2,3,175,0
32,4,0,0,0,0,0,36,0
375,36,1,5,0,3,23,443,0
13,20,0,2,0,0,2,37,0
8,53,0,0,0,0,4,65,0
39,67,1,4,0,0,0,111,0
265,22,2,2,0,1,13,305,1
28,0,0,0,0,0,0,28,0
611,51,5,4,1,9,19,700,0
138,4,0,0,0,0,2,144,0
129,6,0,5,0,0,3,143,0
80,15,0,1,0,0,7,103,0
61,1,0,0,0,0,1,63,0
27,0,0,0,0,0,0,27,0
98,6,0,7,0,0,0,111,0
111,1,0,1,0,0,6,119,1
53,0,0,1,0,0,0,54,0
10,0,0,0,0,0,0,10,0
167,11,0,8,0,2,2,190,0
54,0,0,0,0,0,0,54,0
42,0,0,3,0,0,0,45,0
52,0,0,0,0,1,0,53,0
46,0,0,0,0,0,0,46,0
30,0,0,4,0,0,0,34,0
43,0,0,0,0,0,0,43,0
44,0,0,0,0,0,0,44,0
53,2,0,0,0,0,3,58,0
25,0,0,0,0,0,3,28,0
26,0,0,0,0,0,0,26,0
45,0,0,1,0,1,0,47,2
158,9,0,0,0,0,1,168,0
78,1,0,0,0,0,1,80,0
33,0,0,0,0,0,0,33,0
57,51,0,5,0,0,3,116,0
44,2,0,6,0,0,0,52,0
16,0,0,0,0,0,0,16,0
30,6,0,0,1,0,4,41,0
31,0,0,6,0,0,1,38,0
49,0,0,0,0,2,2,53,0
152,5,0,1,0,0,2,160,0
31,0,0,1,0,0,0,32,0
21,0,0,1,0,0,0,22,0
10,1,0,1,0,0,1,13,0
31,0,0,0,0,0,0,31,0
14,0,0,0,0,0,3,17,0
51,0,0,0,0,0,0,51,0
52,2,0,0,0,0,4,58,0
71,10,0,1,0,0,4,86,0
27,0,0,0,0,0,0,27,0
46,6,0,0,0,0,5,57,0
30,0,0,0,0,0,0,30,0
36,1,0,1,0,0,3,41,1
13,0,0,0,0,0,0,13,0
30,0,0,0,0,0,0,30,0
12,0,0,0,0,0,0,12,0
63,0,0,0,0,1,0,64,0
59,0,0,0,0,0,0,59,0
22,0,0,0,0,0,0,22,0
47,0,0,0,0,0,0,47,0
22,0,0,0,0,0,0,22,0
82,0,0,2,0,0,2,86,0
72,3,0,0,0,0,1,76,1
53,0,0,4,0,0,0,57,0
0,0,0,1,0,0,0,1,0
33,0,0,0,0,0,0,33,0
38,0,0,0,0,0,0,38,0
26,2,0,0,0,0,0,28,0
12,0,0,1,0,0,1,14,0
25,0,0,1,0,0,2,28,0
28,0,0,0,0,0,0,28,0
21,0,0,0,0,0,0,21,0
32,0,0,0,0,0,1,33,0
33,4,1,0,0,3,1,42,1
52,0,0,0,0,0,0,52,0
56,0,0,0,0,0,0,56,0
57,0,0,0,0,0,0,57,0
61,1,0,0,0,1,1,64,1
4,6,0,1,0,0,0,11,0
26,6,0,0,0,0,0,32,0
36,26,0,0,0,0,0,62,0
37,16,0,0,0,0,8,61,0
49,4,0,2,0,0,1,56,0
63,19,0,0,0,0,9,91,0
67,14,0,0,0,0,10,91,0
32,15,0,2,0,2,0,51,0
49,6,0,0,0,5,7,67,0
7,3,0,0,0,0,0,10,0
5,4,0,0,0,0,0,9,0
44,4,0,0,0,4,0,52,0
43,8,0,1,0,0,1,53,0
101,1,0,3,0,0,4,109,0
92,3,0,0,0,0,2,97,0
117,0,0,0,0,0,0,117,0
36,0,0,1,0,0,0,37,0
27,0,0,1,0,0,0,28,0
106,0,0,1,0,3,3,113,1
157,22,1,3,0,0,3,186,0
109,6,0,0,0,0,0,115,0
116,1,0,2,0,1,0,120,0
156,7,1,5,0,0,4,173,0
113,0,0,9,0,0,8,130,0
137,1,0,0,0,0,1,139,0
101,4,0,1,0,0,7,113,0
25,0,0,0,0,0,0,25,0
31,0,0,0,0,0,0,31,0
52,0,0,0,0,0,0,52,0
29,0,0,1,0,0,3,33,0
30,5,0,1,0,0,2,38,0
42,0,0,0,0,0,2,44,0
40,0,0,0,0,0,0,40,0
58,0,0,2,0,0,0,60,0
45,0,0,0,0,0,0,45,0
36,0,0,0,0,0,0,36,0
40,0,0,0,0,0,0,40,0
39,0,0,0,0,0,0,39,0
25,0,0,0,0,0,0,25,0
50,3,0,0,0,0,0,53,0
35,7,0,0,0,0,5,47,0
48,0,0,0,0,0,0,48,0
43,0,0,0,0,0,0,43,0
49,1,0,0,0,0,3,53,0
51,0,0,1,0,0,1,53,1
41,0,0,0,0,0,0,41,0
51,0,0,0,0,0,6,57,0
42,0,0,1,0,0,1,44,0
37,0,0,0,0,0,3,40,0
48,0,0,0,0,0,0,48,0
45,0,0,1,0,0,0,46,0
34,0,0,8,0,0,5,47,0
61,0,0,0,0,0,0,61,0
40,0,0,0,0,0,0,40,0
43,0,0,1,0,0,1,45,0
42,0,0,1,0,0,2,45,0
52,0,0,0,0,0,0,52,0
54,0,0,0,0,0,0,54,0
48,0,0,0,0,0,4,52,0
45,0,0,0,0,0,0,45,0
34,0,0,0,0,0,0,34,0
60,11,0,0,0,0,0,71,0
18,1,0,0,0,0,1,20,1
29,0,0,2,0,0,0,31,0
33,0,0,0,0,0,1,34,0
67,12,0,0,0,0,3,82,0
62,0,0,0,0,0,3,65,0
92,6,0,1,0,0,3,102,0
81,1,0,1,0,0,0,83,0
67,14,0,0,0,0,0,81,0
96,0,0,0,0,0,0,96,0
106,1,0,0,0,2,0,109,0
90,0,0,1,0,0,4,95,0
89,0,0,2,0,0,3,94,0
94,1,0,0,0,0,0,95,0
102,22,0,2,0,2,1,129,0
4,0,0,0,0,0,0,4,0
1,0,0,0,0,0,0,1,0
20,25,0,0,0,10,4,59,0
180,264,0,13,0,19,19,495,0
6,12,0,2,0,0,1,21,0
27,47,0,2,0,10,1,87,1
2,16,0,0,0,1,0,19,0
28,14,0,0,0,0,1,43,0
57,18,0,0,2,0,0,77,0
7,15,0,3,0,0,0,25,0
0,9,0,0,0,0,0,9,0
7,1,0,1,0,0,2,11,0
25,2,0,3,0,0,0,30,0
74,23,2,0,0,0,1,100,0
440,359,10,39,0,58,40,946,0
55,144,0,29,0,22,5,255,0
39,52,2,17,0,1,3,114,0
57,113,1,27,0,1,10,209,0
10,62,0,5,0,9,5,91,0
3,8,0,0,0,0,1,12,0
11,0,0,0,0,0,0,11,0
7,9,0,9,0,2,1,28,0
109,139,0,5,3,56,28,340,0
0,4,0,0,0,7,0,11,0
8,12,0,0,0,0,0,20,0
5,5,0,0,0,4,0,14,0
8,71,0,0,0,3,8,90,0
62,122,0,0,0,56,7,247,0
34,81,2,4,1,1,3,126,0
0,0,0,1,0,0,0,1,0
176,102,0,1,0,3,9,291,0
62,96,3,3,0,34,10,208,0
68,74,4,5,0,4,9,164,0
81,91,0,7,0,15,12,206,0
92,98,0,2,0,12,15,219,0
38,8,0,2,0,23,4,75,0
69,28,0,2,0,4,9,112,0
70,50,1,0,0,0,7,128,0
86,65,0,0,0,0,7,158,0
90,16,0,2,0,5,0,113,0
61,22,0,3,0,0,6,92,0
32,10,0,0,0,0,0,42,0
44,8,2,1,0,9,3,67,0
76,23,1,0,0,2,0,102,1
68,6,1,0,0,0,0,75,0
83,5,0,6,0,0,0,94,0
26,1,0,0,0,0,2,29,0
52,5,0,3,0,0,9,69,0
113,8,0,0,0,6,14,141,0
66,1,1,0,0,0,5,73,1
88,5,0,0,0,0,3,96,0
120,7,0,1,1,2,5,136,0
67,2,0,0,0,0,0,69,0
35,2,0,0,0,2,0,39,0
79,86,0,4,0,0,3,172,0
41,5,1,4,0,0,2,53,1
41,0,0,0,0,6,0,47,0
124,44,1,1,0,2,8,180,0
14,3,0,0,0,0,0,17,0
1,0,0,0,0,0,0,1,0
6,0,0,0,0,3,0,9,0
43,10,0,0,0,13,1,67,0
0,0,0,0,0,0,1,1,0
9,0,0,0,0,0,0,9,0
48,0,0,0,0,27,0,75,0
18,0,0,0,0,13,0,31,0
61,25,0,4,0,4,0,94,0
176,213,0,4,0,17,24,434,0
35,6,0,4,0,0,0,45,0
30,19,0,0,0,1,14,64,0
72,20,0,2,0,16,5,115,0
25,18,0,4,0,0,9,56,0
88,67,1,0,0,0,6,162,0
72,36,2,1,0,22,5,138,0
38,30,0,0,0,9,11,88,0
226,64,0,5,0,21,3,319,0
130,20,0,0,0,0,7,157,0
59,3,0,13,0,0,5,80,0
50,14,0,9,0,20,1,94,0
138,1,4,15,0,2,13,173,0
53,17,0,0,0,0,3,73,0
66,57,0,0,0,13,8,144,0
47,18,0,0,0,4,17,86,0
26,9,0,1,0,0,3,39,0
34,4,0,2,0,6,3,49,0
92,43,0,0,0,0,12,147,0
61,43,0,0,0,5,0,109,0
59,1,0,0,0,6,4,70,0
56,3,0,6,0,4,0,69,0
83,73,0,2,0,3,9,170,0
69,5,0,4,0,2,3,83,0
104,26,0,0,0,6,0,136,0
102,34,0,7,0,0,1,144,0
303,133,0,8,0,16,25,485,0
10,12,6,6,0,1,0,35,0
21,1,0,0,0,0,1,23,0
18,7,0,8,0,0,1,34,0
46,157,3,0,0,6,7,219,0
20,4,0,0,0,0,0,24,0
35,4,0,0,0,0,3,42,0
36,5,0,0,0,0,0,41,0
73,72,7,0,0,3,12,167,0
2,0,0,0,0,0,0,2,0
6,6,0,3,0,4,0,19,0
15,0,0,0,0,0,0,15,0
56,19,0,0,0,0,3,78,0
86,11,0,1,0,4,2,104,0
92,20,0,0,0,9,10,131,0
40,0,0,0,0,0,0,40,0
50,1,0,0,0,0,1,52,1
22,4,0,0,0,0,0,26,0
37,6,0,0,0,0,0,43,0
67,11,0,0,0,0,0,78,0
64,3,0,0,0,9,0,76,0
24,2,0,1,0,2,0,29,0
33,8,0,0,0,0,0,41,0
40,5,0,2,0,5,1,53,0
105,10,1,0,0,7,13,136,0
62,1,0,0,0,1,0,64,0
77,1,0,0,0,9,0,87,0
61,4,3,0,0,0,2,70,0
22,0,0,0,0,0,2,24,0
96,1,0,0,0,6,4,107,0
114,11,0,3,0,1,0,129,0
94,19,0,0,0,22,0,135,0
118,19,4,1,0,2,7,151,0
63,14,0,0,0,0,4,81,0
87,8,1,0,0,5,1,102,0
35,4,1,0,0,0,2,42,0
15,10,0,0,0,0,0,25,0
8,1,0,0,0,1,2,12,0
20,14,0,0,0,0,3,37,0
38,9,0,0,0,1,4,52,0
48,2,0,0,0,10,2,62,0
46,3,7,0,0,6,0,62,0
29,2,0,0,0,4,0,35,0
30,12,0,0,0,0,0,42,0
37,10,1,0,0,7,0,55,0
37,4,0,0,0,0,5,46,0
61,0,0,0,0,3,5,69,0
54,1,1,0,0,0,0,56,1
37,2,0,0,0,0,2,41,0
23,7,3,0,0,0,0,33,0
19,0,0,0,0,0,0,19,0
49,19,0,0,0,0,0,68,0
29,6,0,0,0,12,4,51,0
33,8,1,3,0,6,2,53,0
45,4,0,1,0,1,2,53,0
47,11,2,1,0,0,4,65,0
41,8,0,0,0,0,3,52,0
21,5,0,4,0,2,7,39,0
57,1,0,0,0,0,0,58,1
39,9,0,4,0,0,0,52,0
58,0,0,0,0,0,0,58,0
52,15,0,3,0,2,0,72,0
31,4,0,0,0,2,0,37,0
13,2,0,0,0,0,0,15,0
2,0,0,0,0,0,1,3,0
15,9,0,0,1,1,1,27,1
10,10,0,0,0,0,2,22,0
17,6,0,0,0,0,0,23,0
31,5,0,0,0,0,0,36,0
17,10,0,0,0,0,0,27,0
14,1,0,0,0,1,0,16,0
26,22,0,0,0,0,0,48,0
35,6,0,0,0,0,4,45,0
31,15,0,5,0,0,0,51,0
49,11,0,0,0,0,0,60,0
27,17,0,2,0,0,4,50,0
17,7,0,0,0,0,3,27,0
46,55,0,1,0,10,2,114,0
24,10,0,0,0,0,0,34,0
5,0,0,0,0,0,1,6,0
6,0,0,0,0,0,0,6,0
30,17,0,0,0,0,0,47,0
63,71,1,0,0,0,3,138,0
30,42,0,0,0,0,4,76,0
56,39,1,0,0,0,5,101,0
45,63,0,0,0,9,4,121,0
68,79,0,12,0,1,0,160,0
75,34,0,1,0,0,1,111,1
30,36,0,0,0,0,2,68,0
74,43,0,0,0,0,3,120,0
40,47,0,6,0,0,0,93,0
29,33,0,3,0,0,1,66,1
16,13,0,0,0,15,0,44,0
29,51,0,1,0,0,0,81,1
17,12,0,0,0,0,0,29,0
18,23,0,0,0,4,0,45,0
110,128,0,1,0,7,11,257,0
26,33,0,0,0,1,3,63,0
17,9,0,0,0,9,0,35,0
32,44,0,0,0,2,3,81,0
37,37,0,0,0,0,2,76,0
27,73,0,0,0,0,11,111,0
23,41,0,0,0,0,3,67,0
87,250,0,3,0,28,26,394,0
93,102,0,1,0,9,12,217,1
58,150,1,5,0,15,18,247,0
8,23,0,0,0,0,0,31,0
31,37,0,0,0,0,1,69,1
28,36,0,1,0,2,0,67,1
46,38,0,2,0,0,4,90,0
49,31,6,0,0,4,2,92,0
18,42,0,4,0,3,0,67,0
51,46,1,2,0,13,1,114,0
44,66,0,1,0,5,3,119,0
23,28,0,0,0,0,1,52,0
28,75,0,6,0,0,6,115,0
113,270,3,0,0,38,19,443,0
32,40,0,2,1,1,1,77,0
21,90,0,0,0,0,9,120,0
25,23,0,1,0,0,2,51,0
13,22,0,0,0,0,0,35,0
50,106,0,7,1,3,5,172,0
8,24,0,3,0,0,0,35,0
50,91,0,0,0,10,11,162,0
30,44,0,1,0,11,7,93,1
22,61,0,0,0,0,3,86,0
69,69,0,2,0,7,9,156,0
153,484,1,4,0,37,48,727,1
3,48,0,0,0,2,1,54,0
4,2,0,0,0,0,0,6,0
1,0,0,0,0,0,1,2,0
19,38,0,0,0,3,2,62,0
32,19,0,0,0,9,0,60,0
25,56,0,4,0,0,8,93,0
38,17,1,1,0,6,2,65,1
22,35,0,0,0,0,5,62,0
23,37,0,0,0,4,0,64,0
14,42,0,0,0,0,0,56,0
26,46,1,15,0,0,1,89,0
44,104,0,25,0,0,3,176,0
25,35,0,0,0,0,0,60,0
69,30,1,0,0,0,0,100,0
4,6,0,0,0,0,0,10,0
21,0,1,0,0,12,0,34,0
24,0,2,1,0,15,0,42,0
25,1,2,0,0,10,2,40,0
2,25,0,0,0,5,1,33,0
107,77,0,2,0,11,15,212,0
12,42,0,0,0,1,6,61,0
12,43,0,0,0,0,2,57,0
33,63,0,0,0,0,2,98,0
20,42,0,11,0,8,0,81,0
97,63,0,6,0,15,6,187,0
75,93,0,6,0,1,6,181,0
43,71,0,0,0,1,11,126,0
38,20,0,3,0,6,1,68,0
34,3,0,0,1,0,1,39,0
57,22,0,1,0,0,6,86,0
57,39,0,0,0,17,2,115,0
0,0,0,2,0,2,1,5,1
43,34,0,0,0,1,4,82,1
29,11,0,0,0,0,1,41,0
46,44,1,4,0,9,3,107,0
37,7,0,0,0,0,4,48,0
35,32,0,0,0,0,0,67,0
25,19,4,0,0,2,1,51,0
53,19,0,1,0,1,1,75,0
61,49,0,1,0,5,4,120,0
40,18,1,0,0,0,3,62,0
26,44,0,1,0,0,0,71,0
25,33,0,1,0,0,1,60,0
19,43,0,0,0,0,4,66,0
21,20,1,0,0,0,0,42,0
22,27,0,0,0,8,3,60,0
25,25,0,0,0,0,0,50,0
39,71,0,0,0,4,5,119,0
44,43,0,0,0,0,3,90,0
17,39,0,0,0,0,0,56,0
25,30,0,0,0,0,0,55,0
69,121,0,6,0,4,12,212,0
39,20,1,5,0,1,3,69,1
33,75,0,13,0,6,3,130,0
60,82,0,6,0,0,7,155,0
41,49,0,0,0,1,3,94,0
25,54,0,5,0,1,0,85,0
6,46,0,1,0,0,2,55,0
3,3,0,0,0,0,0,6,0
7,2,0,0,0,0,0,9,0
2,0,0,0,0,0,0,2,0
30,36,0,0,0,0,0,66,0
29,83,0,0,0,14,6,132,0
19,99,4,1,0,9,5,137,0
24,49,0,1,0,0,2,76,0
15,13,0,0,0,0,0,28,0
12,25,0,0,1,0,0,38,0
15,41,0,0,0,2,0,58,0
25,54,0,0,0,0,1,80,0
16,40,0,4,0,0,2,62,0
18,59,0,2,0,9,5,93,0
20,60,0,7,0,0,3,90,0
41,36,0,0,0,0,2,79,0
33,28,0,0,0,5,2,68,0
43,53,0,2,0,8,2,108,0
23,42,0,0,0,0,0,65,0
27,30,0,1,0,0,1,59,0
34,26,3,2,0,0,0,65,0
19,30,0,0,0,0,1,50,0
27,37,0,0,0,2,3,69,0
55,65,0,6,0,0,4,130,0
47,194,5,0,0,8,0,254,0
54,279,0,8,0,6,18,365,0
4,37,0,0,0,0,0,41,0
25,53,0,2,0,18,1,99,0
27,21,0,0,0,0,0,48,0
37,54,0,0,0,8,0,99,0
88,306,0,9,1,148,36,588,0
4,110,0,0,0,16,20,150,0
24,210,1,0,0,68,9,312,1
107,348,0,5,0,1,6,467,0
3,44,0,0,0,6,1,54,0
3,56,0,0,0,2,1,62,0
0,9,0,0,0,0,0,9,0
122,239,3,8,0,39,18,429,0
6,0,0,0,0,0,0,6,0
9,5,0,0,0,0,0,14,0
9,0,0,0,0,0,0,9,0
7,21,0,0,0,0,1,29,0
78,150,1,11,0,1,11,252,0
183,354,1,4,0,53,16,611,0
4,26,0,0,0,0,0,30,0
0,0,0,1,0,0,0,1,0
6,82,1,1,0,0,5,95,0
64,163,1,3,0,1,2,234,0
2,3,0,0,0,0,0,5,0
1,0,0,0,0,0,0,1,1
19,36,0,0,0,0,0,55,0
210,661,1,13,3,115,42,1045,0
7,84,0,0,0,0,2,93,0
12,48,0,0,0,0,0,60,0
82,929,1,7,8,138,50,1215,0
12,128,0,0,0,4,4,148,0
1,101,1,0,12,1,5,121,0
14,51,0,0,0,0,1,66,0
5,62,0,0,0,0,3,70,0
164,208,0,0,0,28,22,422,0
21,34,0,0,0,0,3,58,0
10,16,0,0,0,0,0,26,0
18,22,0,0,0,10,5,55,0
100,124,1,0,0,13,9,247,0
18,16,0,0,0,0,4,38,0
152,561,5,10,0,13,28,769,0
37,46,0,0,0,1,8,92,0
6,15,0,0,1,0,1,23,0
6,11,0,0,0,0,0,17,0
17,107,1,1,0,9,2,137,0
2,20,1,0,0,0,0,23,1
4,23,0,0,0,0,0,27,0
17,157,0,0,0,2,1,177,0
33,135,0,5,0,10,6,189,0
26,99,0,3,0,0,2,130,0
5,34,0,0,0,4,0,43,0
16,54,0,0,0,6,1,77,1
9,126,1,0,0,0,2,138,0
27,170,0,0,0,0,4,201,0
7,44,0,0,0,0,2,53,0
9,31,0,0,0,0,0,40,0
3,50,0,0,0,0,0,53,0
1,44,0,0,0,0,1,46,1
11,39,0,0,0,0,0,50,0
5,43,0,1,0,0,8,57,0
38,203,0,0,0,2,5,248,0
1,100,0,0,0,0,1,102,0
5,35,0,0,0,0,6,46,0
1,85,0,0,0,0,4,90,0
2,52,0,0,0,0,0,54,0
0,34,0,0,0,0,0,34,0
5,15,0,0,0,0,0,20,0
16,148,0,1,0,1,9,175,1
0,55,0,0,0,0,0,55,0
0,27,0,0,0,3,0,30,0
1,39,0,0,0,5,0,45,0
6,33,0,0,0,0,0,39,0
2,59,0,0,0,0,0,61,0
5,59,1,0,0,0,3,68,0
21,211,0,4,0,2,14,252,0
1,59,0,0,0,0,6,66,0
2,61,0,0,0,0,0,63,0
8,79,0,1,0,0,3,91,0
33,21,0,0,0,0,1,55,0
97,61,0,13,0,3,11,185,0
6,6,0,0,0,0,0,12,0
11,23,0,0,0,0,0,34,0
21,18,0,0,0,0,5,44,0
95,65,0,4,0,2,5,171,0
7,0,0,0,0,0,0,7,0
13,25,2,0,0,0,0,40,0
6,14,0,0,0,0,0,20,0
15,77,0,1,0,1,2,96,0
12,25,0,0,0,0,0,37,0
18,70,1,0,0,3,3,95,0
10,29,1,0,0,0,2,42,0
14,69,0,1,0,0,1,85,1
3,120,1,0,0,4,7,135,1
5,88,0,16,0,0,0,109,0
29,92,0,12,0,0,4,137,0
21,106,0,9,0,1,3,140,0
23,124,0,1,0,1,4,153,1
33,70,0,11,0,0,5,119,0
15,61,0,1,0,2,0,79,1
16,34,0,2,0,5,4,61,0
9,33,0,12,0,0,2,56,0
15,69,0,14,0,0,5,103,0
30,70,0,3,0,0,12,115,0
35,171,2,1,0,0,7,216,0
43,125,0,5,0,2,12,187,0
7,50,0,1,0,0,2,60,0
16,37,0,7,0,0,0,60,0
3,17,0,0,0,0,2,22,0
8,82,0,0,0,0,10,100,0
28,107,0,3,0,3,9,150,0
12,39,1,2,0,0,3,57,0
46,177,0,24,0,3,7,257,0
2,2,0,0,0,0,0,4,0
25,64,0,10,0,0,1,100,1
7,16,0,0,0,0,0,23,0
20,61,0,0,0,1,3,85,0
13,58,2,3,0,0,1,77,0
0,27,0,0,0,0,0,27,0
9,42,0,11,0,0,0,62,0
13,55,0,0,0,9,0,77,0
8,45,0,0,0,0,0,53,0
3,6,0,0,0,6,1,16,0
0,30,0,0,0,0,0,30,0
2,28,0,0,0,0,0,30,0
15,121,1,2,0,1,5,145,0
13,54,1,0,0,0,2,70,1
8,59,0,0,0,0,0,67,0
11,72,0,0,0,6,1,90,0
11,27,0,5,0,0,2,45,0
11,58,0,4,0,0,0,73,0
18,13,0,0,0,0,0,31,0
30,121,1,17,0,0,9,178,0
22,102,0,8,0,2,5,139,0
6,159,0,6,0,10,11,192,0
1,46,0,0,0,0,3,50,0
19,169,1,8,0,2,5,204,0
7,29,0,0,0,0,0,36,0
10,54,0,0,0,0,1,65,0
38,196,0,2,0,1,5,242,0
6,36,0,0,0,0,3,45,0
7,35,0,0,0,0,2,44,0
1,19,2,0,0,0,4,26,0
12,138,0,1,0,1,2,154,1
0,24,2,1,0,4,1,32,0
0,41,0,0,0,0,0,41,0
335,567,2,8,0,14,45,971,0
130,242,0,2,0,8,16,398,0
17,23,0,0,0,0,5,45,0
8,53,1,0,0,0,1,63,1
59,94,0,1,0,4,17,175,0
22,54,0,1,0,4,6,87,0
210,125,1,24,0,1,9,370,1
178,65,1,11,0,6,9,270,0
21,12,0,1,0,0,2,36,0
7,9,0,0,0,0,7,23,0
39,25,0,4,0,0,1,69,0
45,7,0,0,0,1,3,56,0
33,30,0,0,0,0,1,64,0
47,49,0,1,0,0,5,102,0
4,5,0,0,0,0,0,9,0
36,136,1,6,0,2,15,196,0
12,36,0,0,0,0,0,48,0
75,285,5,0,0,23,18,406,0
69,222,0,0,0,0,13,304,0
14,60,0,1,0,0,0,75,1
10,47,0,0,0,2,0,59,0
12,116,1,4,0,1,6,140,1
40,190,6,5,0,0,4,245,0
5,39,0,0,0,0,10,54,0
13,148,0,0,0,1,4,166,0
17,87,0,0,0,6,5,115,0
14,93,0,2,0,0,0,109,0
51,146,0,12,0,3,6,218,0
7,14,0,2,0,0,0,23,0
13,22,0,0,0,4,2,41,0
51,347,0,1,0,23,7,429,0
25,47,0,1,0,0,8,81,1
6,50,0,0,0,0,2,58,0
3,44,0,0,0,3,0,50,0
24,80,0,5,0,0,3,112,0
0,72,0,0,0,0,1,73,0
6,107,0,1,0,0,5,119,0
7,142,2,0,0,7,7,165,0
62,260,0,13,0,46,7,388,0
13,150,2,3,0,8,7,183,0
33,155,0,0,0,9,13,210,0
25,89,0,1,0,23,12,150,0
47,17,0,0,0,8,4,76,0
81,15,0,0,0,6,8,110,0
110,13,0,0,0,1,2,126,0
95,39,0,3,0,3,8,148,0
65,25,0,1,0,1,0,92,0
74,12,0,0,0,0,1,87,0
23,113,1,0,0,10,4,151,0
60,10,2,5,0,14,3,94,0
81,8,0,0,0,1,2,92,0
65,13,0,3,0,7,8,96,0
70,90,1,6,0,5,13,185,1
85,64,0,4,0,11,29,193,0
16,11,0,0,0,2,1,30,0
33,3,0,0,0,0,0,36,0
138,59,1,3,0,3,17,221,0
28,26,0,0,0,4,5,63,0
26,17,0,0,0,8,0,51,0
87,28,0,0,0,2,15,132,0
58,20,3,10,0,5,13,109,0
18,11,0,0,0,0,0,29,0
115,142,3,2,0,17,16,295,0
1,1,0,0,0,0,0,2,1
27,1,0,0,0,3,0,31,0
0,2,0,0,0,0,0,2,0
0,5,0,0,0,0,0,5,0
262,431,3,9,0,139,28,872,0
82,15,0,8,0,3,6,114,0
21,24,0,0,0,12,0,57,0
5,20,0,0,0,6,6,37,0
45,14,0,0,0,0,0,59,0
10,34,0,0,0,5,2,51,0
141,110,2,2,0,0,16,271,0
31,2,0,0,0,0,2,35,0
77,28,0,1,0,0,9,115,0
45,16,1,0,0,0,0,62,0
43,11,0,1,0,0,2,57,1
24,5,0,9,0,0,0,38,0
150,135,0,1,0,12,7,305,0
10,13,0,0,0,0,0,23,0
31,85,2,0,0,2,7,127,0
102,207,3,4,0,17,13,346,0
47,17,0,0,1,1,7,73,0
43,13,0,0,0,0,2,58,0
465,351,1,3,0,8,25,853,0
2,0,0,0,0,0,0,2,0
27,4,0,0,0,0,0,31,0
5,3,0,0,0,0,0,8,0
23,0,0,0,0,0,0,23,0
55,14,1,0,0,0,0,70,1
5,0,0,0,0,0,0,5,0
29,5,0,0,0,0,2,36,0
35,10,0,0,0,1,0,46,0
15,4,0,1,0,0,0,20,0
17,13,0,0,0,0,0,30,0
5,0,0,0,0,0,0,5,0
8,0,0,0,0,0,0,8,0
25,4,0,1,0,0,0,30,0
27,81,0,2,1,2,19,132,0
28,4,0,0,0,0,0,32,0
34,11,0,0,0,0,0,45,0
8,6,0,0,0,0,0,14,0
49,72,0,0,0,0,11,132,0
18,30,0,5,0,2,4,59,0
12,24,0,2,0,0,0,38,0
53,52,1,4,0,0,1,111,0
25,51,0,0,0,0,6,82,0
15,13,0,0,0,0,3,31,0
12,4,0,0,0,0,0,16,0
74,107,1,3,0,3,6,194,0
333,235,1,7,0,3,9,588,0
29,2,0,0,0,4,1,36,0
39,29,0,1,0,2,2,73,0
46,8,0,0,0,0,0,54,0
2,0,0,0,0,0,0,2,0
13,2,0,0,0,0,3,18,0
78,54,0,0,0,1,2,135,1
81,32,0,2,0,0,7,122,0
126,31,0,0,0,0,1,158,0
12,0,0,0,0,0,0,12,0
4,1,0,0,0,0,0,5,0
40,24,0,0,0,3,0,67,0
28,25,0,4,0,0,0,57,0
5,0,0,0,0,0,0,5,0
135,0,0,0,0,0,0,135,0
38,9,0,0,0,0,0,47,0
222,328,0,13,0,6,24,593,0
35,68,2,5,0,0,5,115,0
18,47,0,0,0,0,6,71,0
48,184,0,1,0,10,5,248,0
5,21,0,0,0,5,5,36,0
39,92,0,5,0,1,3,140,0
143,31,0,7,0,7,0,188,0
74,8,0,0,0,0,1,83,0
81,19,0,0,0,0,0,100,0
68,14,1,8,0,0,1,92,0
158,27,0,6,0,0,3,194,0
54,8,0,2,0,1,0,65,0
4,0,0,0,0,0,0,4,0
19,2,0,0,0,1,0,22,0
44,5,0,0,0,0,0,49,0
18,6,0,0,0,0,2,26,0
6,0,0,0,0,0,0,6,0
10,0,0,0,0,0,0,10,0
42,37,0,0,0,0,0,79,0
227,86,1,5,0,2,9,330,0
35,7,0,0,0,0,1,43,1
24,0,0,0,0,0,0,24,0
41,27,0,6,0,0,0,74,0
19,18,0,0,0,0,0,37,0
17,29,0,0,0,0,0,46,0
8,9,0,0,0,0,0,17,0
6,2,0,0,0,0,0,8,0
9,7,0,1,0,0,0,17,0
23,16,0,4,0,0,0,43,0
25,14,0,0,0,0,0,39,0
121,33,1,0,0,0,5,160,0
10,12,0,0,0,1,0,23,0
17,7,0,0,0,0,2,26,0
4,0,0,0,0,0,0,4,0
16,6,0,0,0,0,1,23,0
31,21,0,0,5,0,3,60,0
18,15,0,1,0,0,0,34,0
100,34,0,0,0,0,1,135,0
30,7,0,0,0,0,0,37,0
52,17,0,0,0,0,0,69,0
40,28,0,0,0,0,0,68,0
39,8,1,0,0,0,0,48,0
50,1,0,0,0,0,0,51,0
94,67,0,1,0,7,16,185,0
9,0,0,0,0,6,0,15,0
10,0,0,0,0,0,0,10,0
5,2,0,0,0,0,0,7,0
2,1,0,0,0,0,0,3,0
2,0,0,0,0,0,0,2,0
7,0,0,0,0,0,0,7,0
18,12,0,0,0,0,0,30,0
33,0,0,0,0,3,0,36,0
73,16,0,1,0,4,2,96,0
38,4,0,1,0,0,0,43,0
76,18,0,0,0,0,3,97,0
83,19,0,0,0,0,0,102,0
26,7,0,0,0,0,2,35,0
141,39,0,0,0,0,1,181,0
14,2,0,0,0,0,0,16,0
110,21,0,3,0,1,2,137,0
91,6,0,0,1,0,2,100,0
53,20,0,0,2,0,0,75,0
51,12,1,0,0,0,3,67,0
84,14,0,0,0,0,0,98,0
31,2,0,0,0,0,0,33,0
36,4,0,0,0,0,0,40,0
27,17,0,0,0,0,1,45,0
135,24,0,1,0,1,3,164,0
63,4,0,2,0,0,1,70,0
62,12,0,0,0,0,0,74,0
70,4,0,0,0,0,0,74,0
61,4,0,0,0,0,0,65,0
33,5,0,0,0,0,4,42,0
5,2,0,0,0,0,0,7,0
28,1,0,0,0,0,2,31,0
35,9,0,0,0,0,1,45,0
19,0,0,0,0,3,1,23,1
18,0,0,0,0,0,4,22,0
19,11,0,0,0,0,2,32,0
37,33,0,1,0,0,0,71,0
8,19,0,0,0,0,4,31,0
74,22,1,3,0,5,2,107,0
11,0,0,2,0,0,0,13,0
23,9,0,0,0,0,0,32,0
9,4,0,0,0,0,1,14,1
51,25,0,2,0,4,3,85,0
1,6,0,0,0,0,0,7,0
0,0,0,0,0,0,3,3,0
122,69,0,0,0,3,13,207,0
87,46,0,7,0,1,3,144,0
3,0,0,0,0,0,1,4,1
23,0,0,0,0,0,0,23,0
4,0,0,0,0,0,0,4,0
20,0,0,0,0,0,0,20,0
229,69,0,15,0,0,5,318,0
113,22,0,4,0,1,0,140,0
46,2,0,5,0,0,2,55,0
10,3,0,0,0,0,1,14,1
3,0,0,0,0,0,0,3,0
30,36,0,1,0,0,6,73,0
136,41,0,0,0,0,1,178,0
7,1,0,0,0,0,0,8,0
7,4,0,0,0,1,3,15,0
17,0,0,0,0,0,0,17,0
33,0,0,3,0,0,2,38,0
78,28,1,0,0,0,2,109,0
25,3,0,0,0,0,0,28,0
12,8,0,0,0,0,0,20,0
54,18,0,3,0,0,0,75,0
58,24,0,1,0,0,1,84,0
34,12,0,0,0,1,4,51,0
2,0,0,0,0,0,0,2,0
0,3,0,0,0,0,0,3,0
28,16,0,0,0,0,3,47,0
28,7,0,0,0,1,0,36,0
187,223,0,0,0,19,30,459,0
16,20,0,0,0,0,3,39,0
30,76,0,2,0,1,0,109,0
21,65,0,1,0,0,4,91,0
17,78,0,0,0,4,0,99,0
59,3,0,0,0,1,2,65,0
15,3,0,0,0,0,0,18,0
12,0,0,0,0,0,0,12,0
25,8,0,0,0,0,0,33,0
14,9,1,0,0,0,0,24,0
7,0,0,0,0,0,0,7,0
240,150,2,10,0,8,21,431,0
17,12,0,0,0,0,0,29,0
5,2,0,0,0,0,0,7,0
17,31,0,2,0,0,0,50,0
35,15,0,0,0,0,1,51,0
5,0,0,0,0,0,0,5,0
7,3,0,2,0,0,0,12,0
16,19,0,0,0,0,2,37,0
230,452,4,13,0,18,34,751,0
91,131,0,1,0,10,15,248,0
9,19,0,0,0,0,0,28,0
404,419,6,10,0,21,26,886,0
7,0,0,0,0,0,0,7,0
5,86,1,3,0,0,8,103,0
54,104,0,6,0,0,6,170,0
6,11,0,0,0,0,0,17,0
30,93,0,0,0,9,0,132,0
13,4,0,0,0,0,0,17,0
0,4,0,0,0,1,0,5,0
77,503,1,0,0,14,31,626,0
16,83,0,0,0,0,2,101,0
30,106,0,0,0,1,0,137,0
25,64,0,0,0,1,1,91,1
18,51,0,0,0,0,2,71,0
16,52,1,0,0,0,0,69,1
42,119,2,5,0,8,13,189,0
24,95,0,1,0,1,3,124,1
28,61,0,0,0,1,2,92,1
27,26,0,0,0,4,2,59,0
28,33,0,3,0,0,0,64,0
24,53,0,0,0,1,0,78,1
35,51,1,3,0,0,0,90,1
36,56,0,0,2,0,6,100,0
57,62,0,0,0,0,8,127,0
15,20,0,1,0,0,2,38,0
41,34,0,3,0,0,0,78,0
68,36,2,4,0,6,3,119,0
26,60,0,0,0,0,0,86,0
15,26,0,0,0,0,0,41,0
62,23,0,0,0,0,10,95,0
85,157,1,7,0,0,11,261,0
58,84,0,7,0,4,2,155,0
24,11,0,6,0,0,0,41,0
21,73,0,0,0,3,4,101,0
43,56,0,0,0,0,2,101,0
30,17,0,1,0,0,2,50,0
58,79,0,0,0,0,0,137,0
62,31,0,5,0,0,0,98,0
62,53,1,4,0,3,3,126,0
45,34,0,2,0,5,3,89,0
27,27,0,0,0,6,0,60,0
36,31,0,0,0,1,2,70,1
94,150,1,10,0,11,2,268,0
12,25,0,0,0,0,7,44,0
35,31,0,0,0,1,5,72,0
38,69,1,0,0,0,2,110,0
93,363,0,3,0,0,10,469,0
3,87,0,0,0,1,3,94,1
17,45,1,0,0,0,5,68,0
9,76,0,5,0,3,2,95,0
98,87,1,0,0,7,14,207,0
17,108,1,0,0,4,0,130,0
39,62,1,6,0,0,6,114,0
18,34,0,0,0,1,3,56,0
0,24,0,5,0,0,1,30,0
9,55,0,2,0,0,0,66,0
52,76,1,0,0,9,4,142,0
29,40,0,7,0,1,0,77,0
0,1,0,0,0,0,0,1,1
40,215,0,1,0,8,3,267,0
6,52,0,3,0,1,0,62,0
4,23,0,0,0,0,1,28,0
24,108,0,0,0,11,11,154,0
8,43,0,3,0,0,2,56,0
12,17,0,0,0,0,0,29,0
0,41,0,0,0,0,2,43,0
4,23,0,0,0,0,0,27,0
2,10,0,0,0,0,0,12,0
4,149,1,1,0,0,0,155,0
11,65,0,1,0,0,0,77,1
22,28,1,0,0,10,1,62,1
15,81,0,0,0,0,4,100,0
49,109,1,0,0,3,14,176,0
40,135,0,3,0,6,3,187,0
2,0,0,0,0,0,0,2,0
0,10,0,0,0,0,7,17,0
5,56,0,0,0,0,0,61,0
0,93,0,0,0,0,0,93,0
7,277,0,0,0,0,9,293,0
0,18,0,0,0,0,0,18,0
14,360,2,5,0,6,20,407,0
8,45,0,5,0,5,5,68,0
9,147,1,0,0,8,9,174,0
13,167,1,8,0,0,18,207,0
4,64,0,0,0,0,9,77,0
65,24,0,0,0,2,4,95,0
113,32,0,2,0,0,12,159,0
58,50,2,10,0,4,6,130,0
32,13,0,0,0,0,0,45,0
47,12,0,0,0,5,3,67,0
96,102,0,0,0,1,17,216,0
1,3,0,0,0,0,2,6,0
23,19,0,1,0,0,4,47,0
86,76,0,0,0,0,10,172,0
19,9,0,0,0,0,8,36,0
81,114,0,0,0,5,10,210,0
22,45,0,0,0,3,2,72,0
13,15,0,0,0,0,7,35,0
61,48,0,0,0,1,5,115,0
6,0,0,0,0,0,0,6,0
4,24,0,0,0,0,0,28,0
15,7,0,0,0,0,0,22,0
31,11,0,0,0,0,0,42,0
121,181,0,7,0,14,16,339,0
28,26,0,0,0,0,4,58,0
11,38,0,0,0,4,1,54,0
16,35,0,7,0,0,5,63,0
128,187,0,7,0,8,30,360,0
15,46,0,0,0,0,0,61,0
59,38,1,8,0,0,2,108,0
35,16,0,0,0,0,1,52,0
106,39,0,3,0,0,2,150,0
58,40,0,5,0,0,3,106,0
43,16,0,0,0,5,2,66,0
141,104,1,1,0,21,14,282,0
21,5,0,0,0,0,0,26,0
19,9,0,0,0,0,0,28,0
10,18,0,0,0,6,6,40,0
18,33,0,0,1,0,3,55,0
61,32,0,1,0,3,0,97,0
46,53,0,1,0,1,0,101,2
86,61,2,8,0,0,11,168,0
45,1,0,0,0,0,4,50,0
73,30,0,0,0,0,11,114,0
53,46,0,4,0,0,3,106,0
54,123,1,5,0,0,14,197,0
105,283,3,4,3,31,13,442,0
24,26,1,7,0,0,2,60,0
11,34,0,0,0,0,0,45,0
20,6,0,0,0,2,6,34,0
40,24,0,0,0,6,4,74,0
81,287,1,1,0,2,21,393,0
26,54,0,1,0,2,3,86,0
19,71,0,1,0,3,3,97,0
30,85,0,2,0,1,5,123,0
17,1,0,2,0,0,0,20,0
0,3,0,0,0,0,0,3,0
0,0,0,0,0,0,1,1,0
6,0,0,0,0,0,0,6,0
7,0,0,0,0,0,0,7,0
4,4,0,0,0,0,0,8,0
3,0,0,0,0,0,1,4,0
167,229,0,6,0,20,21,443,0
4,2,0,0,1,1,2,10,0
52,133,2,2,0,4,7,200,0
7,2,0,0,0,0,4,13,0
12,16,0,0,0,0,0,28,0
47,37,0,1,0,1,5,91,1
2,0,0,1,0,0,1,4,1
0,0,0,1,0,0,0,1,0
16,0,0,0,0,0,0,16,0
7,0,0,0,0,0,0,7,0
9,0,0,0,0,0,0,9,0
7,0,0,0,0,0,0,7,0
11,0,0,0,0,0,0,11,0
6,0,0,0,0,0,0,6,0
0,9,0,0,0,0,0,9,0
45,29,0,8,0,2,0,84,0
12,18,0,0,0,2,2,34,0
0,3,0,0,0,0,0,3,0
12,0,0,0,0,0,0,12,0
224,158,1,11,0,57,13,464,1
0,2,0,0,0,0,0,2,0
22,7,0,0,0,0,2,31,0
0,2,0,0,0,0,0,2,0
23,32,0,0,0,0,4,59,0
53,56,2,1,0,2,1,115,0
64,38,1,1,0,0,7,111,0
52,33,0,0,0,4,5,94,0
14,6,1,0,0,0,4,25,1
207,511,0,3,0,6,51,778,0
3,8,0,0,0,0,0,11,0
50,70,0,0,3,6,5,134,0
3,5,0,0,0,0,0,8,0
65,50,0,1,0,0,0,116,1
29,42,1,1,0,0,5,78,0
34,72,0,6,0,0,7,119,0
38,48,0,0,0,0,1,87,0
130,38,0,2,0,0,2,172,0
49,15,0,0,0,2,0,66,0
44,12,0,2,0,3,9,70,0
32,0,0,0,0,0,5,37,0
23,23,1,0,0,0,1,48,0
34,13,0,1,0,0,6,54,0
35,45,0,1,0,4,3,88,0
38,18,1,2,0,0,2,61,0
55,28,0,2,0,0,6,91,0
99,44,0,2,0,10,13,168,0
143,95,2,8,0,2,2,252,0
30,7,0,0,0,0,1,38,0
47,45,0,0,0,0,5,97,0
27,24,0,0,0,1,4,56,0
27,39,0,0,0,0,1,67,0
23,6,0,6,0,0,0,35,0
31,15,0,0,0,1,1,48,0
15,11,0,0,0,0,0,26,0
23,11,0,0,0,2,2,38,0
66,37,0,0,0,8,2,113,0
38,17,0,3,0,0,7,65,0
72,56,0,8,0,1,8,145,1
30,21,0,3,0,0,0,54,0
25,23,0,7,0,0,4,59,0
20,10,0,0,0,0,0,30,0
36,43,0,0,0,0,2,81,0
46,51,0,3,0,2,6,108,0
108,25,0,1,0,0,0,134,0
86,22,0,0,0,0,0,108,0
309,79,0,5,0,5,26,424,0
21,5,0,0,0,0,0,26,0
15,6,0,0,0,0,0,21,0
71,44,0,0,0,0,3,118,0
60,16,0,0,0,0,1,77,0
59,11,0,8,0,0,0,78,0
75,27,0,0,0,0,0,102,0
142,5,0,6,0,0,0,153,0
138,12,0,0,0,0,8,158,0
94,24,0,0,0,0,0,118,0
81,24,0,6,0,4,3,118,0
112,58,0,0,0,0,10,180,0
30,0,1,0,0,0,0,31,0
124,3,0,0,0,0,2,129,0
32,0,0,0,0,0,0,32,0
64,27,0,11,0,0,0,102,0
66,8,0,1,0,0,0,75,1
11,0,0,0,0,0,1,12,1
109,30,0,0,0,0,5,144,0
1,0,0,1,0,0,2,4,0
70,53,1,4,0,0,2,130,1
48,23,2,9,0,2,0,84,0
20,18,0,4,0,0,2,44,0
17,9,0,1,0,0,1,28,0
187,82,0,15,0,0,12,296,0
31,14,0,5,0,0,0,50,0
205,402,4,6,0,4,38,659,0
91,16,0,0,0,0,5,112,0
45,6,0,1,0,0,1,53,0
53,20,0,0,0,3,1,77,0
5,9,0,0,0,0,6,20,0
126,114,2,31,0,8,19,300,0
39,27,0,2,0,2,1,71,0
10,77,0,0,0,0,13,100,0
5,0,0,0,0,1,0,6,0
15,13,0,2,0,0,2,32,0
88,170,0,2,0,4,17,281,0
38,80,0,0,0,0,5,123,0
48,46,0,0,0,9,10,113,0
98,7,0,0,0,0,3,108,0
16,18,0,0,0,0,5,39,0
176,13,0,1,0,3,1,194,0
29,4,0,0,0,0,0,33,0
26,100,1,0,0,0,15,142,0
20,0,0,0,0,0,0,20,0
192,12,2,9,0,0,6,221,0
30,19,0,0,0,1,0,50,1
53,18,2,0,0,0,0,73,0
11,0,0,0,0,0,0,11,0
186,11,0,0,0,0,10,207,0
81,0,0,0,0,0,0,81,0
65,2,0,0,0,0,5,72,0
66,0,0,0,0,5,3,74,0
72,4,0,0,0,0,1,77,0
49,0,0,0,0,0,0,49,0
14,30,0,0,0,0,2,46,0
328,130,3,9,0,5,24,499,0
10,5,0,0,0,0,0,15,0
62,19,0,2,1,0,4,88,0
18,4,0,0,0,1,2,25,0
16,6,0,0,0,0,0,22,0
46,0,0,0,0,0,0,46,0
78,1,0,0,0,0,7,86,0
75,2,1,4,0,0,0,82,0
78,4,0,0,0,0,0,82,0
48,1,0,0,0,0,1,50,1
65,5,0,0,0,4,3,77,0
98,5,1,0,0,1,4,109,0
122,0,0,2,0,0,0,124,0
89,3,0,0,0,6,0,98,0
47,1,0,0,0,0,7,55,0
78,3,0,0,0,3,4,88,0
25,0,0,0,0,0,9,34,0
99,5,0,0,0,0,3,107,0
55,1,0,0,0,0,0,56,0
23,0,0,0,0,0,0,23,0
18,10,0,0,0,0,0,28,0
22,1,0,5,0,0,0,28,0
40,9,0,0,0,0,3,52,0
278,29,2,1,0,5,18,333,0
42,3,0,5,0,0,12,62,0
38,6,0,0,0,1,5,50,1
28,6,0,0,0,4,5,43,0
40,0,0,1,0,0,2,43,0
39,11,0,0,0,0,1,51,0
43,0,0,0,0,0,5,48,0
39,7,0,0,0,0,3,49,0
60,7,0,0,0,6,5,78,0
57,6,0,0,0,0,4,67,0
109,42,0,1,0,0,4,156,0
85,13,0,1,0,0,0,99,0
42,0,0,4,0,3,0,49,0
67,1,0,0,0,0,0,68,0
48,11,0,0,0,0,5,64,0
56,12,0,0,0,5,0,73,0
29,10,0,0,0,0,2,41,0
66,4,1,1,0,0,6,78,0
73,20,0,0,7,6,6,112,0
50,15,0,1,0,0,5,71,0
37,8,0,0,0,0,0,45,0
27,0,0,0,0,2,0,29,0
104,148,1,3,0,10,9,275,0
67,104,0,0,0,4,4,179,0
46,11,0,0,1,0,0,58,0
66,3,1,2,0,0,0,72,0
36,3,0,0,0,0,3,42,0
37,12,0,0,0,0,6,55,0
36,2,0,0,0,2,1,41,0
59,7,0,0,0,1,0,67,0
58,0,0,0,0,0,2,60,0
55,7,0,0,0,1,11,74,0
39,9,0,1,0,6,4,59,1
34,4,0,0,0,0,0,38,0
168,232,6,6,1,11,40,464,0
15,16,0,0,0,0,1,32,0
70,5,0,0,0,0,2,77,0
47,13,0,0,0,0,1,61,0
46,5,0,0,0,0,1,52,0
44,1,1,0,0,0,1,47,0
72,11,1,2,0,0,9,95,0
24,113,0,0,0,14,1,152,0
31,1,0,2,0,0,2,36,1
45,5,0,0,0,2,6,58,0
247,45,1,5,0,3,2,303,0
48,0,0,0,0,0,1,49,0
55,43,0,1,0,2,3,104,0
92,22,0,2,0,0,8,124,0
38,0,0,1,0,1,1,41,0
49,2,0,0,0,0,0,51,0
105,1,0,0,0,0,0,106,0
50,0,0,0,0,0,0,50,0
78,17,0,0,0,0,2,97,0
84,3,0,0,0,1,0,88,1
190,13,1,0,0,0,7,211,0
159,90,0,0,0,3,10,262,0
88,7,1,1,0,0,3,100,0
21,1,0,0,0,0,0,22,0
24,0,0,0,0,0,0,24,0
121,7,1,4,0,0,2,135,0
50,4,0,0,0,0,3,57,0
36,9,0,0,0,0,0,45,0
20,0,0,0,0,0,0,20,0
32,2,0,0,0,2,0,36,0
5,0,0,0,0,0,0,5,0
46,5,0,0,0,0,0,51,0
18,0,0,0,0,0,0,18,0
51,2,0,0,0,2,6,61,0
77,7,0,0,0,0,1,85,0
0,3,0,0,0,0,0,3,0
2,0,0,0,0,0,0,2,0
5,0,0,0,0,0,0,5,0
5,0,0,0,0,0,0,5,0
7,0,0,0,0,0,0,7,0
17,0,0,0,0,0,0,17,0
6,0,0,0,0,0,0,6,0
12,0,0,0,0,0,0,12,0
35,0,0,0,0,0,0,35,0
2,0,0,0,0,0,0,2,0
6,0,0,0,0,0,0,6,0
12,0,0,0,0,0,0,12,0
50,8,0,0,0,0,5,63,0
40,0,0,0,0,0,2,42,0
19,0,0,0,0,0,0,19,0
42,4,0,0,0,0,1,47,0
127,37,0,2,0,0,5,171,0
5,0,0,0,0,0,0,5,0
111,17,0,0,0,0,2,130,0
11,1,0,0,0,0,3,15,1
34,16,0,12,0,0,2,64,0
41,23,0,4,0,0,2,70,0
277,111,0,20,0,2,12,422,0
43,6,0,0,0,0,3,52,0
16,6,0,0,0,0,0,22,0
20,5,0,0,0,0,0,25,0
19,0,0,1,0,0,0,20,0
32,5,2,1,0,0,3,43,0
81,50,1,8,0,0,4,144,0
17,25,0,6,0,2,4,54,0
45,17,0,12,0,0,2,76,0
240,64,1,1,0,2,11,319,0
178,39,0,4,0,4,2,227,0
31,3,0,0,0,0,0,34,0
32,5,0,2,0,0,0,39,0
82,9,0,1,0,0,2,94,1
370,598,0,4,0,13,30,1015,0
96,82,0,2,0,3,18,201,0
13,17,0,0,0,0,0,30,0
21,24,0,0,1,0,5,51,0
32,50,0,0,0,0,0,82,0
28,22,1,0,0,7,0,58,0
49,53,1,0,0,1,2,106,1
31,9,0,4,0,0,0,44,0
152,167,3,0,0,42,32,396,0
78,31,0,2,0,3,3,117,0
35,39,0,0,0,3,4,81,0
33,28,3,0,0,0,4,68,0
33,20,0,0,0,0,0,53,0
59,33,0,2,0,0,11,105,0
27,83,0,0,0,8,5,123,0
54,33,0,0,0,17,5,109,0
40,47,0,0,0,16,8,111,0
1,13,0,0,0,0,0,14,0
2,0,0,0,0,0,0,2,0
76,2,0,0,0,0,0,78,0
30,6,0,0,0,0,0,36,0
7,0,0,0,0,0,0,7,0
4,0,0,0,0,0,0,4,0
67,7,0,0,0,0,3,77,0
235,20,1,2,0,0,5,263,0
4,0,0,0,0,0,0,4,0
0,1,0,0,0,0,0,1,0
27,9,0,2,0,0,0,38,0
2,0,0,0,0,0,0,2,0
291,41,0,9,8,0,9,358,0
38,5,0,4,0,0,0,47,0
157,81,3,3,0,0,24,268,0
99,5,0,0,0,5,5,114,0
38,22,0,0,0,0,0,60,0
66,33,0,14,0,2,9,124,0
39,31,0,0,0,0,5,75,0
22,12,0,0,0,0,0,34,0
33,7,0,0,0,0,0,40,0
49,8,1,0,0,0,3,61,0
5,0,0,0,0,0,0,5,0
21,22,0,6,0,0,4,53,0
2,0,0,0,0,0,0,2,0
134,11,0,0,0,0,0,145,0
63,13,0,0,0,0,5,81,0
46,0,0,0,0,0,0,46,0
5,0,0,0,0,0,0,5,0
6,0,0,0,0,0,0,6,0
1,0,0,0,0,0,0,1,0
1,0,0,0,0,0,0,1,0
71,6,0,0,0,0,0,77,0
14,0,0,0,0,0,2,16,0
11,0,0,0,0,0,1,12,0
2,1,0,4,0,0,3,10,1
6,1,0,0,0,0,0,7,0
3,2,0,0,0,0,0,5,0
3,0,0,0,0,0,0,3,0
32,6,0,2,0,0,4,44,0
2,0,0,0,0,0,0,2,0
10,0,1,0,0,0,1,12,1
45,37,4,0,0,0,0,86,0
3,0,0,0,0,0,0,3,0
1,0,0,0,0,0,0,1,0
7,0,0,0,0,1,2,10,0
71,33,0,10,0,0,0,114,0
34,18,0,6,0,0,0,58,0
70,15,0,5,0,0,1,91,0
31,14,0,0,0,0,0,45,0
38,59,0,4,0,0,4,105,0
43,39,0,7,0,0,3,92,0
98,41,0,3,0,2,0,144,0
26,11,0,5,0,0,0,42,0
6,8,0,0,0,0,0,14,0
11,1,0,0,0,0,2,14,0
69,15,0,0,0,3,0,87,0
157,28,0,6,0,3,12,206,0
39,20,0,0,0,1,1,61,1
24,44,0,5,0,0,6,79,0
71,14,0,0,0,0,6,91,0
63,9,0,3,0,0,5,80,0
27,6,0,4,0,0,0,37,0
30,1,0,0,0,0,2,33,0
546,52,2,8,0,11,27,646,0
0,2,0,0,0,0,0,2,0
61,10,0,2,0,2,0,75,0
69,0,4,0,0,7,3,83,0
73,0,0,0,0,4,0,77,0
5,0,0,0,0,0,0,5,0
28,3,0,0,0,0,0,31,0
14,0,0,0,0,3,0,17,0
2,0,0,0,0,0,0,2,0
29,0,0,0,0,8,0,37,0
2,0,0,0,0,0,1,3,1
45,5,0,0,0,0,5,55,0
34,0,0,5,0,0,0,39,0
23,0,0,0,0,0,0,23,0
3,3,0,0,0,0,0,6,0
8,2,0,0,0,0,0,10,0
44,1,0,0,0,3,1,49,0
57,12,0,0,0,1,2,72,1
86,8,0,0,0,0,4,98,0
50,4,0,0,0,0,3,57,0
25,3,0,0,0,0,0,28,0
116,29,0,1,0,0,10,156,0
47,3,0,1,0,1,0,52,0
27,0,0,0,0,0,0,27,0
35,3,0,2,0,0,0,40,0
20,18,0,4,0,1,0,43,0
106,14,1,0,0,6,7,134,0
36,24,0,0,5,0,5,70,0
20,10,0,0,0,0,2,32,0
113,28,0,0,0,1,4,146,0
173,78,0,8,0,3,12,274,0
107,8,0,0,0,1,2,118,1
32,2,1,0,0,0,0,35,0
20,10,0,1,0,0,1,32,0
120,15,0,0,0,9,8,152,0
72,2,0,0,0,11,2,87,0
16,107,0,0,0,0,8,131,0
11,67,1,8,0,0,3,90,0
8,70,0,1,0,3,6,88,0
5,9,0,0,0,0,0,14,0
175,30,1,5,0,0,10,221,0
25,4,0,0,0,4,0,33,0
220,66,0,3,0,15,6,310,0
57,27,0,1,0,0,0,85,0
75,28,0,2,0,10,5,120,0
72,23,1,0,0,1,6,103,1
51,7,0,0,0,0,0,58,0
62,6,0,2,0,0,5,75,0
60,27,0,1,0,1,5,94,0
68,10,0,1,0,2,4,85,0
147,52,0,2,0,0,13,214,0
0,25,0,5,0,0,0,30,0
36,2,0,0,0,0,4,42,0
92,6,1,0,0,0,0,99,0
109,25,0,0,2,4,6,146,0
90,22,0,2,0,6,0,120,0
311,38,0,1,0,7,7,364,0
113,22,0,0,0,0,15,150,0
44,6,0,0,0,0,2,52,0
162,16,1,0,6,0,8,193,0
52,13,0,0,0,1,0,66,0
86,0,0,0,0,4,0,90,0
156,20,0,0,0,0,3,179,0
76,31,0,0,0,1,4,112,0
87,19,0,0,0,0,3,109,0
114,25,0,1,0,1,9,150,0
102,22,0,0,0,6,9,139,0
82,12,0,0,0,0,7,101,0
124,52,3,2,0,0,18,199,0
99,0,0,0,0,0,0,99,0
227,54,1,12,0,0,12,306,0
119,15,0,0,0,0,1,135,0
108,10,1,1,0,0,8,128,0
79,17,1,0,0,1,1,99,0
72,7,0,0,0,0,6,85,0
71,25,0,0,0,0,0,96,0
95,21,0,0,0,0,3,119,0
78,5,0,0,0,0,3,86,0
126,10,0,0,0,0,0,136,0
132,335,0,0,1,20,24,512,1
14,139,0,4,0,0,0,157,0
245,147,1,17,0,2,9,421,0
39,10,0,0,0,1,1,51,0
56,8,2,0,0,0,7,73,0
102,19,0,5,0,0,0,126,0
28,7,0,0,0,0,0,35,0
21,16,0,9,0,0,0,46,0
34,27,0,0,0,0,2,63,0
39,7,0,15,0,0,0,61,0
77,16,0,0,0,0,4,97,0
50,17,0,0,0,3,0,70,0
109,17,0,6,0,2,10,144,0
60,3,0,0,0,0,1,64,1
31,3,0,1,0,0,0,35,0
90,44,0,1,0,0,3,138,1
41,7,0,0,0,0,0,48,0
48,4,0,0,0,0,0,52,0
95,4,0,3,0,0,2,104,0
46,4,0,0,0,0,1,51,0
47,12,0,0,0,5,0,64,0
51,6,0,0,0,0,0,57,0
53,1,1,0,0,0,0,55,0
49,8,0,0,0,0,0,57,0
73,9,0,1,0,0,0,83,0
45,13,0,0,5,0,0,63,0
28,1,0,0,0,0,0,29,0
76,8,0,3,0,0,0,87,0
132,0,1,1,0,2,3,139,0
5,3,0,0,0,0,0,8,0
17,3,0,0,0,0,0,20,0
19,0,0,0,0,0,1,20,0
12,0,0,0,0,0,0,12,0
7,0,0,0,0,0,0,7,0
16,0,0,0,0,0,1,17,0
12,0,0,0,0,0,0,12,0
250,136,3,18,0,6,21,434,0
24,10,0,0,0,0,0,34,0
0,2,0,0,0,0,0,2,0
32,16,1,2,0,0,1,52,0
9,0,0,0,0,0,0,9,0
4,0,0,0,0,0,0,4,0
464,129,1,5,0,6,16,621,1
188,56,0,6,0,0,16,266,0
69,12,1,0,0,0,6,88,1
75,69,0,3,0,0,6,153,0
20,5,0,0,0,2,0,27,0
83,24,0,1,1,4,5,118,0
102,16,0,4,0,0,0,122,0
130,21,0,1,0,1,9,162,0
120,22,0,2,0,1,6,151,0
48,2,0,5,0,0,0,55,0
21,9,0,0,0,0,6,36,0
69,9,0,0,0,0,0,78,0
65,18,0,0,0,0,4,87,0
43,1,0,0,0,0,3,47,0
66,1,0,0,0,0,0,67,0
453,198,1,14,1,11,16,694,0
48,17,0,0,0,3,1,69,1
50,6,0,4,0,0,0,60,0
51,10,0,0,0,5,5,71,0
43,5,0,1,0,0,2,51,0
18,13,0,0,0,1,0,32,0
32,28,1,0,0,0,0,61,0
46,5,0,10,0,2,0,63,0
24,43,1,0,0,4,0,72,0
35,1,0,1,0,6,7,50,0
20,16,0,2,0,4,0,42,0
39,22,0,0,0,0,0,61,0
10,0,0,0,0,0,1,11,0
22,23,0,0,0,0,0,45,0
161,179,1,10,0,15,14,380,0
21,32,0,1,0,0,2,56,0
10,19,0,0,0,0,0,29,0
27,24,0,0,0,0,0,51,0
41,18,0,1,0,2,0,62,1
92,102,2,0,0,9,3,208,0
33,44,0,0,0,0,1,78,1
1,0,0,0,0,0,1,2,0
13,11,0,0,0,0,10,34,0
49,7,0,2,0,0,0,58,0
140,386,4,12,0,12,29,583,0
10,15,0,0,0,0,0,25,0
38,78,0,1,0,5,10,132,0
5,25,0,0,0,0,0,30,0
0,2,0,0,0,0,0,2,0
14,12,0,1,0,0,1,28,0
16,95,0,5,0,6,7,129,0
58,86,0,1,0,6,8,159,0
18,19,0,1,2,0,2,42,0
42,139,0,7,0,3,14,205,0
0,13,0,0,0,0,0,13,0
20,0,0,0,0,0,0,20,0
50,1,0,0,0,0,2,53,0
13,0,0,0,0,0,0,13,0
54,2,0,0,0,0,0,56,0
2,0,0,0,0,0,0,2,0
148,12,0,3,0,1,4,168,0
0,0,0,0,0,0,1,1,1
2,0,0,0,0,0,0,2,0
5,0,0,0,0,0,0,5,0
2,0,0,0,0,0,0,2,0
336,19,2,0,0,3,11,371,0
12,0,0,0,0,0,0,12,0
13,0,0,0,0,0,0,13,0
17,0,0,0,0,0,0,17,0
41,2,0,0,0,0,0,43,0
41,14,1,0,0,0,3,59,0
66,0,1,3,0,0,0,70,0
71,1,0,0,0,1,0,73,0
2,0,0,0,0,0,0,2,0
14,0,0,0,0,2,0,16,0
20,0,0,0,0,0,0,20,0
14,0,0,0,0,0,0,14,0
23,0,0,0,0,0,1,24,0
34,0,0,0,0,0,1,35,0
19,0,0,0,0,0,0,19,0
33,0,0,0,0,0,0,33,0
5,0,0,0,0,0,1,6,0
11,0,0,0,0,0,0,11,0
24,0,0,0,0,0,0,24,0
8,0,0,0,0,0,0,8,0
35,0,0,0,0,0,0,35,0
12,0,0,0,0,0,0,12,0
2,0,0,0,0,0,0,2,0
3,0,0,0,0,0,0,3,0
13,0,0,0,0,0,0,13,0
5,1,0,0,0,0,1,7,0
7,0,0,0,0,0,0,7,0
8,0,0,0,0,0,0,8,0
9,0,0,0,0,0,0,9,0
6,0,0,0,0,0,0,6,0
11,0,0,0,0,0,0,11,0
17,0,0,0,0,0,0,17,0
8,0,0,0,0,0,0,8,0
10,0,0,0,0,0,0,10,0
10,0,0,0,0,0,1,11,0
6,0,0,0,0,3,0,9,0
30,0,0,0,0,0,0,30,0
47,0,0,0,0,0,0,47,0
83,0,0,1,0,0,0,84,0
7,0,0,0,0,0,0,7,0
4,0,0,0,0,0,0,4,0
2,0,0,0,0,0,0,2,0
5,0,0,0,0,0,0,5,0
10,0,0,0,0,0,2,12,0
193,0,0,1,0,0,5,199,0
10,3,0,0,0,0,0,13,0
51,0,0,0,0,2,2,55,0
1,0,0,0,0,0,0,1,0
12,0,0,0,0,0,0,12,0
25,0,0,0,0,0,3,28,0
18,0,0,0,0,0,0,18,0
29,0,0,0,0,0,0,29,0
211,28,0,0,0,0,10,249,0
9,0,0,0,0,0,0,9,0
361,6,2,2,0,3,7,381,0
15,0,0,0,0,0,0,15,0
19,0,0,0,0,0,1,20,0
22,0,0,0,0,3,0,25,0
7,0,0,0,0,0,0,7,0
4,0,0,0,0,0,0,4,0
185,1,1,0,0,0,3,190,1
105,0,1,0,0,1,5,112,0
148,0,0,0,0,0,6,154,0
28,0,0,0,0,0,0,28,0
27,0,0,1,0,0,0,28,0
31,0,0,0,0,0,2,33,0
73,0,0,0,0,0,1,74,0
15,0,4,0,0,0,0,19,0
18,2,0,0,0,7,0,27,0
11,0,0,0,0,0,0,11,0
13,0,0,1,0,0,2,16,0
49,52,0,0,0,0,1,102,0
31,10,0,0,0,0,2,43,0
10,0,0,0,0,0,0,10,0
28,24,0,4,0,3,0,59,0
3,0,0,0,0,0,3,6,0
9,0,0,0,0,1,0,10,0
102,36,0,11,0,0,2,151,0
2,3,0,0,0,0,0,5,0
11,20,0,5,0,0,2,38,0
22,8,0,0,0,0,0,30,0
71,44,0,12,0,0,3,130,0
10,21,0,0,0,0,0,31,0
133,48,0,16,0,11,0,208,0
45,23,1,3,0,0,0,72,0
66,40,0,0,0,0,10,116,0
8,0,0,0,0,0,0,8,0
22,12,1,0,0,3,2,40,0
62,3,0,12,0,1,0,78,1
5,2,0,1,0,0,0,8,0
2,0,0,0,0,1,2,5,0
9,0,0,0,0,0,0,9,0
32,0,0,5,0,0,0,37,0
0,4,0,0,0,0,0,4,0
12,4,0,0,0,3,0,19,0
25,0,0,1,0,0,1,27,1
30,0,0,0,0,0,0,30,0
24,0,0,0,0,0,0,24,0
109,6,0,0,0,0,0,115,0
23,2,0,0,0,0,0,25,0
26,0,0,0,0,0,0,26,0
38,4,0,0,1,0,0,43,0
24,0,0,0,0,0,0,24,0
476,16,1,9,0,5,5,512,0
40,10,0,0,0,0,0,50,0
22,1,0,0,0,0,0,23,0
12,0,0,0,0,0,2,14,0
51,0,0,0,0,0,0,51,0
32,0,0,0,0,0,0,32,0
2,0,0,0,0,0,0,2,0
22,10,0,2,0,0,0,34,0
128,11,0,7,0,1,3,150,0
124,15,0,1,0,0,3,143,0
193,7,0,9,0,0,4,213,0
64,0,0,0,0,0,0,64,0
63,1,0,1,0,0,0,65,0
2,0,0,0,0,0,0,2,0
112,11,0,0,0,0,0,123,0
15,0,0,0,0,2,1,18,0
22,0,0,0,0,0,0,22,0
18,3,0,0,0,0,0,21,0
13,0,0,0,0,0,0,13,0
124,5,0,0,0,0,0,129,0
47,0,0,1,0,0,0,48,0
65,0,0,0,0,0,0,65,0
25,2,0,1,0,0,0,28,0
40,0,0,1,0,0,1,42,0
167,20,0,5,0,1,0,193,0
416,32,0,2,0,0,5,455,0
46,4,0,0,0,5,3,58,0
106,14,0,5,0,0,0,125,0
25,2,0,1,0,3,2,33,0
531,45,0,5,0,8,24,613,0
44,10,0,0,0,0,0,54,0
19,11,0,0,0,0,0,30,0
3,0,0,0,0,0,0,3,0
172,11,4,0,0,0,1,188,0
140,8,0,2,0,0,0,150,0
4,0,0,0,0,0,0,4,0
2,0,0,0,0,0,0,2,0
3,0,0,0,0,0,0,3,0
5,0,0,0,0,0,0,5,0
15,0,0,0,0,0,0,15,0
2,0,0,0,0,0,0,2,0
30,1,0,0,0,0,1,32,1
25,0,0,0,0,0,0,25,0
271,10,0,7,0,1,8,297,0
130,0,0,0,0,0,0,130,0
45,0,0,0,0,0,0,45,0
1,0,0,2,0,0,0,3,0
3,0,0,0,0,0,0,3,0
21,3,0,0,0,0,0,24,0
38,5,0,0,0,0,0,43,0
253,26,0,5,0,0,2,286,0
282,9,0,2,0,0,4,297,0
15,2,0,0,0,0,0,17,0
20,0,0,0,0,0,2,22,0
42,0,0,1,0,0,2,45,0
8,3,0,0,0,0,0,11,0
49,1,1,0,0,0,0,51,1
2,0,0,0,0,0,0,2,0
15,0,0,2,0,0,0,17,0
98,0,0,0,0,0,0,98,0
34,0,0,0,0,0,0,34,0
30,0,0,0,0,0,0,30,0
20,4,0,0,0,0,0,24,0
38,0,0,0,0,0,1,39,0
17,2,0,0,0,0,2,21,0
29,5,0,0,0,0,3,37,0
51,0,0,0,0,0,2,53,0
56,1,0,1,0,1,4,63,0
99,5,0,6,0,0,3,113,0
13,2,0,0,0,0,0,15,0
10,0,0,0,0,0,1,11,0
121,0,0,0,0,1,7,129,0
0,2,0,0,0,0,0,2,0
566,278,0,19,0,16,66,945,0
177,26,0,0,0,1,9,213,0
125,32,0,0,0,6,3,166,0
140,13,1,3,0,6,14,177,0
21,22,0,6,0,0,10,59,0
39,14,0,0,0,0,1,54,0
24,22,0,0,0,0,0,46,0
56,21,0,0,0,0,9,86,0
39,1,0,0,0,0,2,42,0
51,111,0,0,0,2,8,172,0
55,44,0,0,0,0,3,102,0
77,15,0,0,0,0,0,92,0
10,33,0,0,0,0,0,43,0
132,12,0,1,0,0,5,150,0
10,0,0,6,0,0,0,16,0
1,0,0,0,0,0,0,1,0
103,18,0,3,0,0,7,131,0
89,12,0,2,0,0,4,107,0
27,34,0,0,0,0,5,66,0
16,0,0,0,0,0,0,16,0
14,0,0,0,0,0,0,14,0
4,0,0,0,0,0,0,4,0
1,0,0,0,0,0,0,1,0
21,0,0,0,0,0,0,21,0
4,0,0,0,0,0,0,4,0
4,0,0,0,0,0,0,4,0
2,0,0,0,0,0,0,2,0
11,4,0,0,0,0,0,15,0
13,6,1,0,0,0,0,20,0
215,2,0,0,0,34,2,253,0
0,0,0,3,0,0,0,3,0
12,1,0,0,0,0,0,13,0
205,36,0,12,0,1,15,269,0
46,4,0,4,0,0,1,55,0
93,16,0,8,0,4,1,122,1
2,0,0,0,0,0,0,2,0
65,19,3,0,0,0,5,92,0
30,27,0,12,0,0,2,71,0
4,0,0,0,0,0,0,4,0
6,16,0,3,0,12,1,38,0
11,0,0,0,0,0,0,11,0
19,0,0,5,0,0,1,25,1
3,5,0,0,0,0,0,8,0
0,0,0,5,0,0,0,5,0
4,0,0,0,0,0,0,4,0
98,0,0,0,1,0,0,99,0
32,0,0,0,0,0,0,32,0
3,4,0,0,0,0,2,9,0
5,0,0,0,0,0,0,5,0
2,0,0,0,0,0,0,2,0
31,3,0,5,0,0,0,39,0
7,0,0,0,0,0,0,7,0
180,39,1,5,0,1,8,234,0
23,5,0,0,0,0,0,28,0
0,1,0,0,0,0,0,1,0
7,0,0,0,0,0,0,7,0
70,18,0,1,0,0,9,98,0
140,12,0,0,0,0,1,153,0
113,50,0,0,0,0,3,166,0
44,21,1,0,0,0,1,67,0
165,33,1,0,0,4,9,212,0
61,6,0,0,0,1,1,69,0
41,2,0,5,0,2,0,50,0
34,5,0,4,0,4,0,47,0
40,13,0,0,0,0,0,53,0
80,16,0,2,0,3,2,103,0
66,20,0,0,0,5,3,94,0
290,253,2,8,0,27,37,617,0
13,38,0,0,0,5,0,56,0
33,18,0,0,0,4,2,57,0
9,49,0,0,0,0,0,58,0
60,23,0,0,0,4,6,93,0
50,18,0,0,0,0,4,72,0
113,43,0,7,0,0,3,166,0
25,9,0,10,0,0,1,45,0
55,27,0,0,0,5,4,91,0
9,0,0,0,0,0,1,10,0
2,0,0,0,0,0,0,2,0
11,0,0,0,0,0,0,11,0
27,0,0,0,0,0,0,27,0
5,0,0,0,0,0,0,5,0
17,0,0,0,0,0,0,17,0
2,0,0,0,0,0,3,5,0
7,0,0,0,0,0,0,7,0
2,0,0,0,0,0,0,2,0
15,0,0,0,0,0,0,15,0
11,0,0,0,0,0,0,11,0
2,0,0,0,0,0,0,2,0
3,0,0,0,0,0,0,3,0
336,71,0,2,0,3,12,424,0
58,25,0,3,0,0,1,87,0
43,0,0,1,0,0,0,44,0
41,12,0,0,0,0,2,55,0
35,13,0,11,0,0,3,62,0
18,6,0,0,0,0,0,24,0
33,0,0,0,0,0,0,33,0
11,8,0,0,0,0,0,19,0
10,7,0,0,0,0,0,17,0
50,1,0,10,0,0,2,63,0
5,0,0,0,0,0,0,5,0
36,0,0,0,0,0,0,36,0
17,0,0,0,0,0,0,17,0
24,0,0,0,0,0,0,24,0
7,0,0,0,0,0,0,7,0
100,9,0,0,0,0,4,113,0
38,0,0,0,0,0,0,38,0
41,0,0,1,0,0,0,42,0
17,0,0,0,0,0,0,17,0
2,0,0,0,0,0,0,2,0
5,0,0,0,0,0,0,5,0
11,0,0,0,0,0,0,11,0
69,0,0,0,0,1,0,70,0
6,0,0,0,0,2,0,8,0
13,0,0,0,0,0,0,13,0
34,0,0,0,0,0,0,34,0
62,0,0,0,0,1,0,63,0
45,2,0,0,0,0,1,48,0
2,0,0,0,0,0,0,2,0
47,0,0,1,0,0,0,48,1
15,1,0,0,0,0,0,16,0
12,0,0,12,0,0,0,24,0
39,0,0,1,0,0,0,40,0
2,0,0,0,0,0,0,2,0
0,0,0,1,0,0,0,1,0
22,0,0,1,0,0,4,27,0
2,0,0,0,0,0,0,2,0
43,0,0,0,0,0,0,43,0
34,0,0,0,0,0,0,34,0
4,0,0,0,0,0,0,4,0
21,0,0,0,0,0,0,21,0
6,0,0,0,0,0,0,6,0
26,0,0,0,0,0,0,26,0
7,0,0,0,0,0,0,7,0
159,2,0,0,0,0,0,161,0
16,0,0,1,0,0,0,17,1
85,0,0,0,0,0,11,96,0
49,0,0,0,0,0,0,49,0
142,4,0,1,0,0,0,147,0
160,0,2,1,0,0,3,166,0
95,5,0,0,0,0,1,101,0
28,0,0,1,0,0,0,29,0
7,0,0,0,0,0,0,7,0
34,0,0,1,0,0,0,35,0
9,0,0,0,0,0,0,9,0
6,0,0,0,0,0,0,6,0
0,0,0,4,0,0,0,4,0
183,15,9,4,0,0,7,218,0
108,0,0,2,0,3,4,117,0
7,0,1,0,0,0,0,8,0
77,7,0,0,0,0,0,84,0
52,8,0,0,0,0,0,60,0
13,1,0,0,0,0,0,14,0
75,18,0,6,0,0,2,101,0
51,4,0,6,0,6,2,69,0
2,0,0,0,0,0,0,2,0
114,32,0,0,0,0,6,152,0
97,44,1,1,0,0,6,149,1
70,10,0,2,0,0,0,82,0
135,0,0,0,0,0,1,136,0
16,0,0,0,0,0,0,16,0
6,0,0,0,0,0,0,6,0
11,0,0,0,0,0,0,11,0
24,0,0,0,0,2,0,26,0
5,0,0,0,0,0,0,5,0
6,0,0,0,0,0,0,6,0
86,0,0,1,0,0,0,87,0
48,7,0,0,0,0,3,58,0
66,0,0,0,0,0,0,66,0
2,0,0,0,0,0,0,2,0
6,0,0,0,0,0,0,6,0
15,0,0,0,0,0,0,15,0
54,0,0,0,0,0,0,54,0
48,0,0,0,0,0,0,48,0
20,3,0,0,0,0,3,26,0
36,0,0,0,0,0,0,36,0
23,0,0,0,0,0,0,23,0
35,0,0,0,0,0,0,35,0
36,0,0,0,0,0,0,36,0
30,0,0,0,0,0,0,30,0
31,4,0,0,0,0,0,35,0
23,1,0,0,0,0,0,24,0
25,0,3,0,0,0,0,28,0
42,0,0,0,0,0,0,42,0
26,0,0,0,0,0,1,27,1
28,1,0,0,0,0,0,29,1
21,0,0,0,0,0,0,21,0
27,0,0,0,0,0,0,27,0
28,0,0,0,0,0,0,28,0
24,2,0,0,0,0,0,26,0
51,0,0,0,0,0,0,51,0
45,2,1,1,0,0,0,49,1
22,0,0,0,0,0,0,22,0
30,0,0,0,0,0,7,37,0
20,0,0,0,0,0,0,20,0
0,0,0,0,0,0,4,4,0
12,0,0,0,0,0,0,12,0
155,23,0,0,0,1,5,184,1
105,19,0,3,0,1,8,136,0
129,14,0,0,0,0,4,147,0
32,0,0,0,0,0,0,32,0
109,0,0,4,0,0,4,117,0
67,8,0,2,0,0,0,77,0
94,1,0,0,0,0,0,95,1
18,0,0,0,0,0,0,18,0
169,35,0,0,0,3,2,209,0
6,0,0,0,0,0,0,6,0
39,10,0,0,0,0,0,49,0
262,64,1,5,0,5,25,362,0
19,0,0,0,0,0,5,24,0
36,3,0,0,0,0,0,39,0
18,0,0,1,0,0,0,19,0
159,9,1,8,0,0,4,181,0
51,1,0,10,0,0,2,64,1
41,3,0,0,0,0,0,44,0
36,0,0,0,0,0,0,36,0
134,14,0,0,0,0,4,152,0
49,0,0,0,0,0,2,51,0
2,0,0,0,0,0,0,2,0
17,0,0,0,0,0,1,18,0
1,0,0,0,0,0,0,1,0
4,0,0,0,0,0,0,4,0
40,0,0,0,0,0,0,40,0
86,0,2,1,0,0,0,89,1
10,0,0,0,0,0,0,10,0
17,0,0,0,0,0,0,17,0
19,0,0,0,0,0,0,19,0
21,0,0,3,0,0,0,24,0
12,0,0,0,0,0,2,14,0
13,0,0,0,0,0,0,13,0
61,0,0,0,0,0,0,61,0
179,0,0,2,0,3,0,184,0
6,0,0,0,0,0,0,6,0
2,0,0,0,0,1,0,3,0
14,0,0,0,0,0,0,14,0
85,3,0,1,0,0,1,90,0
11,0,0,0,0,0,2,13,0
7,0,0,0,0,0,0,7,0
10,0,0,0,0,0,0,10,0
6,0,1,0,0,0,0,7,0
63,0,0,0,0,0,0,63,0
23,0,0,1,0,0,0,24,0
5,0,0,0,0,0,0,5,0
7,0,0,0,0,0,0,7,0
17,0,0,0,0,0,0,17,0
222,3,0,3,0,0,4,232,0
94,0,0,0,0,0,0,94,0
100,0,1,0,0,5,2,108,0
51,0,0,0,0,0,5,56,0
50,0,0,0,0,0,4,54,0
52,2,0,0,0,0,3,57,0
46,3,0,0,0,0,1,50,0
78,0,0,0,1,0,2,81,0
83,2,1,0,0,0,1,87,1
65,0,0,0,0,0,0,65,0
147,2,2,0,0,0,0,151,0
40,0,0,0,0,0,0,40,0
73,0,0,0,0,0,0,73,0
52,0,0,0,0,0,0,52,0
58,0,0,0,0,0,1,59,0
56,0,0,0,0,0,0,56,0
72,0,0,0,0,0,0,72,0
184,3,1,0,0,0,4,192,0
18,0,0,0,0,0,0,18,0
50,0,0,0,0,0,0,50,0
41,0,0,0,0,1,0,42,0
99,2,1,0,0,0,0,102,0
56,0,0,0,0,0,0,56,0
45,0,0,0,0,0,1,46,1
12,0,0,0,0,0,0,12,0
14,0,0,0,0,0,0,14,0
14,0,0,0,0,1,0,15,0
2,0,0,0,0,0,0,2,0
21,0,0,0,0,1,2,24,0
3,0,0,0,0,0,1,4,0
14,0,0,0,0,0,0,14,0
182,0,0,0,0,0,6,188,0
55,0,0,0,0,0,0,55,0
61,1,0,0,0,0,0,62,0
77,3,1,0,0,0,3,84,0
103,1,0,0,0,0,0,104,1
125,0,0,1,0,0,2,128,0
71,2,0,4,0,0,4,81,0
57,1,0,4,0,0,1,63,0
3,0,0,0,0,0,0,3,0
2,0,0,0,0,0,0,2,0
21,0,0,0,0,0,0,21,0
15,0,0,0,0,0,0,15,0
2,0,0,0,0,0,0,2,0
42,33,0,2,0,0,12,89,0
6,0,0,0,0,0,0,6,0
131,98,0,6,0,15,7,257,0
48,44,0,0,0,0,4,96,0
19,13,0,0,0,1,8,41,0
2,0,0,0,0,0,1,3,0
21,2,0,3,0,0,0,26,0
15,0,0,0,0,0,0,15,0
11,0,0,0,0,0,0,11,0
4,0,0,0,0,0,0,4,0
15,0,0,0,0,0,0,15,0
51,0,0,0,0,0,0,51,0
36,0,0,0,0,0,0,36,0
16,6,0,0,0,0,0,22,0
11,0,0,0,0,0,0,11,0
3,3,0,0,0,0,0,6,0
5,0,0,0,0,0,0,5,0
10,0,0,0,0,0,0,10,0
9,0,0,0,0,0,0,9,0
3,0,0,0,0,0,0,3,0
10,0,0,0,0,0,0,10,0
2,0,0,0,0,0,0,2,0
21,0,0,0,0,0,0,21,0
2,0,0,0,0,0,0,2,0
16,1,0,0,0,0,0,17,0
9,0,0,0,0,0,0,9,0
9,0,0,0,0,0,0,9,0
24,0,0,0,0,0,1,25,1
6,0,0,0,0,0,0,6,0
5,0,0,0,0,0,0,5,0
7,0,0,0,0,0,0,7,0
29,0,0,0,0,0,0,29,0
7,0,0,0,0,0,0,7,0
9,0,0,0,0,0,0,9,0
26,0,0,0,0,0,0,26,0
43,0,0,0,0,1,2,46,0
7,0,0,0,0,0,0,7,0
12,0,0,0,0,0,0,12,0
12,0,0,0,0,0,0,12,0
12,0,0,0,0,0,0,12,0
5,0,0,0,0,0,1,6,0
6,0,0,0,0,0,0,6,0
13,0,0,0,0,0,0,13,0
7,0,0,0,0,0,0,7,0
2,0,0,0,0,0,0,2,0
2,0,0,0,0,0,0,2,0
26,0,0,0,0,0,1,27,0
5,0,0,0,0,0,0,5,0
2,0,0,0,0,0,0,2,0
2,0,0,0,0,0,0,2,0
1,0,0,0,0,0,0,1,0
13,0,0,0,0,0,0,13,0
1,0,0,0,0,0,0,1,0
4,0,0,0,0,0,0,4,0
61,0,2,0,0,0,0,63,0
3,0,0,0,0,0,0,3,0
7,23,0,3,0,1,4,38,0
5,0,0,0,0,0,1,6,0
8,0,0,4,0,0,0,12,0
68,327,1,24,84,0,42,546,0
5,31,0,0,0,1,1,38,1
13,15,0,0,0,0,0,28,0
25,12,0,0,0,0,0,37,0
7,8,0,0,0,0,0,15,0
5,13,0,0,0,0,5,23,0
14,9,0,0,0,0,0,23,0
6,7,0,0,0,0,0,13,0
8,12,0,0,0,5,4,29,0
10,5,0,0,0,0,2,17,0
7,14,0,0,0,0,2,23,0
6,6,0,0,0,0,0,12,0
0,6,0,0,0,0,0,6,0
0,11,0,0,0,0,0,11,0
5,6,0,0,0,0,0,11,0
9,3,0,0,0,0,0,12,0
25,12,0,0,0,0,0,37,0
6,8,0,0,0,0,0,14,0
0,6,0,0,0,0,0,6,0
3,15,0,0,0,3,0,21,0
3,0,0,0,0,0,0,3,0
19,0,0,0,0,0,0,19,0
5,3,0,0,0,0,0,8,0
124,6,0,0,0,15,7,152,0
71,0,0,0,0,2,0,73,0
30,0,0,0,0,1,0,31,0
40,3,0,0,0,0,1,44,0
54,0,0,0,0,0,0,54,0
45,0,0,0,1,0,1,47,0
70,0,0,1,0,0,2,73,0
45,0,0,0,0,0,0,45,0
54,0,0,0,0,4,0,58,0
28,1,0,0,0,0,0,29,0
9,0,0,0,0,0,0,9,0
9,0,0,0,0,0,0,9,0
84,7,0,6,0,0,3,100,0
39,0,0,0,0,0,0,39,0
11,0,0,0,0,0,0,11,0
8,0,0,0,0,0,0,8,0
0,0,0,0,0,0,1,1,1
45,0,0,0,0,0,2,47,0
13,0,0,0,0,0,0,13,0
10,0,0,0,0,2,0,12,0
1,3,0,0,0,0,0,4,0
1,0,0,1,0,0,0,2,1
3,0,0,0,0,0,0,3,0
0,0,0,0,0,0,1,1,0
3,1,0,0,0,0,0,4,0
47,0,0,0,0,0,0,47,0
2,0,0,0,0,0,1,3,1
56,0,0,0,0,0,0,56,0
47,0,0,0,0,0,0,47,0
79,0,0,0,0,0,0,79,0
17,0,0,0,0,0,0,17,0
0,3,0,0,0,0,0,3,0
14,0,0,0,0,0,0,14,0
42,0,2,0,0,0,5,49,0
47,0,1,0,0,0,2,50,0
45,0,0,0,0,0,0,45,0
25,0,0,0,0,1,0,26,1
33,2,3,0,0,0,2,40,0
23,3,4,0,0,0,0,30,0
14,0,0,0,0,0,0,14,0
25,0,0,0,0,0,0,25,0
3,0,0,0,0,0,0,3,0
26,0,0,0,0,0,1,27,0
27,0,0,0,0,0,1,28,0
10,0,0,0,0,0,2,12,0
100,0,0,1,0,0,3,104,0
30,1,0,0,0,0,0,31,0
21,0,0,0,0,0,0,21,0
14,6,0,0,0,0,0,20,0
10,0,0,0,0,0,0,10,0
28,0,0,0,0,0,0,28,0
30,0,0,0,0,0,0,30,0
39,0,0,0,0,0,0,39,0
3,0,0,0,0,0,0,3,0
35,0,0,0,0,1,0,36,0
23,1,0,0,0,0,3,27,0
32,0,0,0,0,0,2,34,0
29,0,0,0,0,0,0,29,0
45,0,0,0,0,0,0,45,0
91,0,0,2,0,0,3,96,0
466,21,0,7,0,11,21,526,0
25,0,0,0,0,0,0,25,0
69,0,0,0,0,0,0,69,0
73,0,0,0,0,0,0,73,0
80,0,6,0,0,0,2,88,0
75,0,0,0,0,0,1,76,1
2,0,0,0,0,0,0,2,0
6,0,0,0,0,0,0,6,0
59,4,0,0,1,10,0,74,0
18,3,0,0,0,0,2,23,0
20,3,0,1,0,0,0,24,0
2,0,0,0,0,0,0,2,0
7,0,0,0,0,0,0,7,0
10,0,0,0,0,0,0,10,0
2,0,0,0,0,0,0,2,0
38,0,0,0,0,0,4,42,0
57,2,0,1,0,0,3,63,0
0,3,0,0,0,0,0,3,0
6,0,0,0,0,0,0,6,0
22,0,0,0,0,0,3,25,0
12,0,0,0,0,0,0,12,0
4,0,0,0,0,0,0,4,0
74,0,0,0,0,0,0,74,0
154,9,0,0,0,2,5,170,0
62,0,0,0,0,0,0,62,0
98,33,0,9,0,0,2,142,0
45,1,0,0,0,3,0,49,1
61,0,0,0,0,0,0,61,0
115,0,4,1,0,0,0,120,0
102,1,0,0,0,0,4,107,0
61,0,0,0,0,0,0,61,0
40,0,0,0,0,0,0,40,0
35,0,0,0,0,0,0,35,0
99,3,0,4,0,7,4,117,0
74,6,0,0,0,1,2,83,0
82,0,0,0,0,0,3,85,0
48,0,0,0,0,0,0,48,0
35,2,0,0,0,0,0,37,0
152,0,0,0,0,0,0,152,0
77,0,0,0,0,2,1,80,0
104,0,0,0,0,0,0,104,0
138,0,0,0,0,0,2,140,0
104,0,0,0,0,0,0,104,0
58,0,0,0,0,0,0,58,0
81,0,0,0,0,0,0,81,0
84,2,0,1,0,0,3,90,0
74,0,0,1,0,0,3,78,0
238,23,0,0,0,7,0,268,0
353,46,1,3,0,5,23,431,0
43,3,0,2,0,0,0,48,0
129,26,0,1,0,5,10,171,0
97,4,2,1,8,0,4,116,0
34,0,0,0,0,0,0,34,0
4,0,0,0,0,0,0,4,0
28,0,0,0,0,0,0,28,0
43,0,0,0,0,0,0,43,0
25,0,0,0,0,0,0,25,0
28,1,0,1,0,0,0,30,0
60,0,0,0,0,0,0,60,0
63,2,0,0,0,0,3,68,0
339,3,0,2,0,0,13,357,0
78,2,0,0,0,1,0,81,0
48,0,1,0,0,0,12,61,0
135,2,0,1,0,0,1,139,1
17,0,0,0,0,0,0,17,0
30,0,0,0,0,0,0,30,0
21,0,0,0,0,0,0,21,0
33,0,0,0,0,0,0,33,0
28,0,0,0,0,0,0,28,0
26,0,0,0,0,0,0,26,0
14,0,0,0,0,0,0,14,0
14,0,0,0,0,0,0,14,0
23,0,0,1,0,0,3,27,0
209,0,0,2,0,1,1,213,0
54,0,0,0,0,0,2,56,0
25,0,0,0,0,0,0,25,0
93,0,0,0,0,1,2,96,1
84,1,0,0,0,3,1,89,0
62,0,0,0,0,0,0,62,0
82,0,0,0,0,0,1,83,0
190,0,0,0,0,0,2,192,0
107,0,0,0,0,0,0,107,0
72,0,0,0,0,0,2,74,0
91,0,0,2,0,0,0,93,0
81,0,0,0,0,0,3,84,0
13,4,0,0,0,9,0,26,0
47,0,0,0,0,0,0,47,0
51,0,0,0,0,0,0,51,0
312,24,2,3,0,1,12,354,0
137,1,1,0,0,5,9,153,0
35,0,0,0,0,0,0,35,0
225,1,0,0,0,3,1,230,1
83,1,0,0,0,0,2,86,0
67,0,0,0,0,0,0,67,0
87,1,0,0,0,0,0,88,1
84,1,2,0,0,2,2,91,0
77,0,0,1,0,1,2,81,0
40,0,0,0,0,0,0,40,0
11,0,0,0,0,0,0,11,0
2,0,0,0,0,0,0,2,0
5,0,0,0,0,0,0,5,0
4,0,0,0,0,0,0,4,0
83,1,0,1,0,0,0,85,1
33,1,0,0,0,0,0,34,1
267,22,0,0,0,7,17,313,0
90,37,0,16,0,0,14,157,0
214,0,1,0,0,7,6,228,0
91,1,0,6,0,0,3,101,0
36,0,0,0,0,0,0,36,0
26,3,0,0,0,0,1,30,0
31,0,0,0,0,1,1,33,0
40,4,0,0,0,0,0,44,0
96,10,0,4,0,0,0,110,0
39,9,0,0,0,0,0,48,0
221,12,1,1,0,1,8,244,0
36,0,0,0,0,0,0,36,0
27,3,0,0,0,1,0,31,0
2,0,0,0,0,4,0,6,0
1,0,0,0,0,1,0,2,1
91,2,0,0,0,0,1,94,0
46,1,0,0,0,0,0,47,0
17,0,0,4,0,0,0,21,0
31,0,0,0,0,0,0,31,0
7,0,0,0,0,0,0,7,0
7,0,0,0,0,0,0,7,0
7,0,0,0,0,0,0,7,0
86,0,0,0,0,0,0,86,0
39,0,0,0,0,0,0,39,0
44,1,0,1,0,0,1,47,0
53,0,1,0,0,0,0,54,0
0,0,0,3,0,0,1,4,1
20,0,0,0,0,0,0,20,0
3,0,0,0,0,0,0,3,0
184,9,0,5,0,0,3,201,0
115,0,0,0,0,0,0,115,0
73,0,0,0,0,0,0,73,0
134,0,0,0,0,1,13,148,0
61,0,0,0,0,0,0,61,0
46,0,0,0,0,0,0,46,0
64,0,0,0,0,0,0,64,0
44,0,0,0,0,0,0,44,0
115,0,0,0,0,0,1,116,0
78,0,0,0,0,1,0,79,0
115,0,0,0,0,0,0,115,0
48,0,0,0,0,0,0,48,0
103,1,0,0,0,0,0,104,0
81,1,0,0,0,0,2,84,0
14,1,0,0,0,0,0,15,0
2,0,0,0,0,0,0,2,0
8,0,0,0,0,0,0,8,0
150,3,0,6,0,0,1,160,0
42,1,0,1,0,0,3,47,0
23,0,0,0,0,0,0,23,0
98,1,0,1,0,0,0,100,1
25,1,0,0,0,0,0,26,0
106,0,0,0,0,0,0,106,0
53,0,0,1,0,0,5,59,0
46,0,0,0,0,6,0,52,0
21,0,0,0,0,0,0,21,0
17,0,0,0,0,0,0,17,0
28,0,0,0,0,0,0,28,0
42,0,0,0,1,0,0,43,0
20,0,0,0,0,0,0,20,0
34,0,0,0,0,0,0,34,0
38,1,0,0,0,0,1,40,0
148,0,0,0,0,0,2,150,0
46,0,0,0,0,0,0,46,0
154,0,0,4,0,3,0,161,0
27,0,0,0,0,0,4,31,0
62,0,0,0,0,0,0,62,0
45,0,0,0,0,0,0,45,0
14,0,0,0,0,0,0,14,0
171,2,1,0,0,0,0,174,0
9,0,0,0,0,0,0,9,0
108,2,0,0,0,0,0,110,0
65,0,0,0,0,0,0,65,0
134,3,0,1,0,3,2,143,1
20,0,0,0,0,0,0,20,0
25,0,0,0,0,1,0,26,0
426,29,0,5,0,36,31,527,0
44,5,0,0,0,9,5,63,0
21,9,0,9,0,21,19,79,0
104,14,0,0,0,23,9,150,0
17,0,0,0,0,10,3,30,0
226,4,2,0,2,14,8,256,0
38,0,0,0,0,0,0,38,0
55,3,0,0,0,6,8,72,0
81,0,0,0,0,0,0,81,0
16,0,0,0,0,0,0,16,0
2,0,0,0,0,0,0,2,0
208,5,0,8,0,0,5,226,0
4,0,0,0,0,0,0,4,0
8,1,0,0,0,0,2,11,0
24,0,0,2,0,1,0,27,0
14,0,0,0,0,0,0,14,0
28,0,0,1,0,0,2,31,0
1,0,0,0,0,0,0,1,0
80,0,0,0,0,0,1,81,0
59,0,0,0,0,0,0,59,0
11,0,0,1,0,0,0,12,0
5,0,0,0,0,0,0,5,0
8,0,0,0,0,0,0,8,0
3,0,0,0,0,0,0,3,0
8,0,0,0,0,0,0,8,0
7,0,0,0,0,0,0,7,0
20,0,0,0,0,0,0,20,0
5,0,0,0,0,0,0,5,0
36,0,0,0,0,0,2,38,0
8,0,0,0,0,0,0,8,0
161,0,1,0,0,0,0,162,0
67,0,0,1,0,0,1,69,0
64,0,0,0,0,0,4,68,0
121,5,0,2,0,1,10,139,0
100,0,0,3,0,0,0,103,0
252,7,1,1,0,0,15,276,0
85,1,0,1,0,0,2,89,0
45,0,0,0,0,0,0,45,0
131,0,0,2,0,0,7,140,0
124,0,0,2,0,0,3,129,0
143,0,0,5,0,0,4,152,0
45,0,0,1,0,0,0,46,1
31,0,0,0,0,0,4,35,0
36,0,0,0,0,0,2,38,0
136,0,0,2,0,0,2,140,0
56,5,0,0,0,0,0,61,0
23,7,0,0,0,1,0,31,0
138,1,0,0,0,0,3,142,0
15,0,0,0,0,0,0,15,0
10,1,0,0,0,0,2,13,0
153,5,0,5,0,1,6,170,0
124,0,1,1,0,0,4,130,2
73,0,0,0,0,0,0,73,0
69,1,0,0,0,0,3,73,0
26,0,0,0,0,0,0,26,0
319,3,0,0,0,2,5,329,0
73,0,0,0,0,0,1,74,0
22,0,0,0,0,0,0,22,0
90,1,0,0,0,2,1,94,0
18,0,0,0,0,0,0,18,0
8,0,0,0,0,0,0,8,0
46,0,0,0,0,0,0,46,0
109,0,0,0,0,0,0,109,0
55,5,0,1,0,0,0,61,0
157,0,0,0,0,0,1,158,0
30,0,0,0,0,0,0,30,0
16,0,0,0,0,0,0,16,0
24,0,0,0,0,0,0,24,0
3,0,0,0,0,0,0,3,0
6,0,0,0,0,0,0,6,0
30,0,0,0,0,0,0,30,0
1,0,0,0,0,0,2,3,0
20,0,0,0,0,0,0,20,0
52,0,0,0,0,0,0,52,0
10,0,0,0,0,0,0,10,0
15,0,1,0,0,4,0,20,0
56,0,0,0,0,0,0,56,0
4,0,0,0,0,0,0,4,0
5,5,0,0,0,0,0,10,0
2,1,0,0,0,0,1,4,0
0,0,0,0,0,0,2,2,0
110,3,0,3,0,0,6,122,0
63,7,0,0,0,3,1,74,0
29,0,0,2,0,0,0,31,0
16,4,0,3,0,0,0,23,0
8,0,0,0,0,0,0,8,0
15,3,0,1,0,0,0,19,0
257,2,0,4,0,1,0,264,0
4,0,0,0,0,0,0,4,0
6,0,0,0,0,0,0,6,0
41,0,0,0,0,0,0,41,0
25,0,1,0,0,0,0,26,0
87,2,0,0,0,0,0,89,0
210,23,3,7,0,3,3,249,0
20,1,0,0,0,0,0,21,0
13,4,0,2,0,1,0,20,0
3,0,0,4,0,0,0,7,0
9,0,0,0,0,0,0,9,0
25,0,0,0,0,0,0,25,0
5,0,0,0,0,0,0,5,0
6,1,0,0,0,0,0,7,0
10,0,0,0,0,0,0,10,0
66,4,0,0,0,0,2,72,0
5,0,0,0,0,0,0,5,0
12,0,0,0,0,0,0,12,0
3,0,0,0,0,0,0,3,0
6,1,0,0,0,0,0,7,0
27,0,0,6,0,0,5,38,0
16,2,0,0,0,0,0,18,0
313,3,0,1,0,0,2,319,0
27,5,0,1,0,0,0,33,0
123,0,0,1,0,0,0,124,0
60,5,0,0,0,0,0,65,0
236,0,0,18,0,1,0,255,0
28,0,0,0,0,0,0,28,0
13,0,0,0,0,0,0,13,0
50,0,0,0,0,0,0,50,0
40,0,0,0,0,0,3,43,0
31,0,0,0,0,1,2,34,0
195,4,0,6,0,2,2,209,0
14,0,0,0,0,0,0,14,0
4,0,0,0,0,0,0,4,0
27,0,0,0,0,0,0,27,0
62,0,0,0,0,0,0,62,0
42,11,0,0,0,0,0,53,0
7,0,0,0,0,0,0,7,0
5,0,0,0,0,0,0,5,0
9,0,0,0,0,4,0,13,0
41,0,0,0,0,0,1,42,0
19,0,0,1,0,1,2,23,0
15,3,0,0,0,0,0,18,0
22,0,0,0,0,0,0,22,0
7,0,0,0,0,0,0,7,0
11,0,0,1,0,0,0,12,1
80,2,0,0,0,0,0,82,0
38,6,0,1,0,0,1,46,0
6,0,0,0,0,0,0,6,0
5,0,0,0,0,0,0,5,0
3,0,0,0,0,0,0,3,0
62,0,0,0,0,1,1,64,0
22,0,0,0,0,0,0,22,0
1,0,0,0,0,0,0,1,0
21,1,0,0,0,0,2,24,0
27,0,0,0,0,0,0,27,0
1,0,0,0,0,0,0,1,0
88,0,0,0,0,0,1,89,1
18,0,0,0,0,0,0,18,0
1,0,0,1,0,0,1,3,0
62,0,0,4,0,0,0,66,0
90,6,1,2,0,3,0,102,0
5,0,0,0,0,0,0,5,0
2,0,0,0,0,0,0,2,0
2,0,0,0,0,0,0,2,0
2,0,0,0,0,0,0,2,0
3,0,0,0,0,0,0,3,0
89,0,0,0,0,0,2,91,0
15,0,0,0,0,0,0,15,0
2,0,0,0,0,0,0,2,0
8,0,0,5,0,0,1,14,0
3,4,0,5,0,0,0,12,0
8,0,0,0,0,0,0,8,0
9,0,0,1,0,0,0,10,0
1,0,0,0,0,0,0,1,0
6,0,0,0,0,0,0,6,0
13,0,0,0,0,0,0,13,0
6,0,0,1,0,0,2,9,0
13,0,0,0,0,0,0,13,0
380,10,4,9,0,1,25,429,0
1,0,0,0,0,0,0,1,0
13,0,0,0,0,0,0,13,0
3,0,0,0,0,0,0,3,0
10,0,0,0,0,0,0,10,0
44,0,0,2,0,0,0,46,0
72,0,0,0,0,0,0,72,0
5,0,0,0,0,0,0,5,0
5,0,0,0,0,0,0,5,0
0,0,0,0,0,0,1,1,0
103,3,2,4,0,0,1,113,0
74,0,0,2,0,0,2,78,0
4,0,0,0,0,0,0,4,0
5,0,0,0,0,0,0,5,0
3,0,0,0,0,0,0,3,0
2,0,0,0,0,0,0,2,0
30,0,0,0,0,0,0,30,0
5,0,0,0,0,0,0,5,0
12,0,0,0,0,0,0,12,0
1,0,0,0,0,0,0,1,0
72,0,0,0,0,0,0,72,0
2,0,0,0,0,0,0,2,0
4,0,0,0,0,0,0,4,0
18,0,0,0,0,0,0,18,0
2,0,0,0,0,0,0,2,0
10,0,0,0,0,0,0,10,0
33,1,0,0,0,0,1,35,0
19,0,0,0,0,0,0,19,0
6,0,0,0,0,0,0,6,0
10,0,0,0,0,0,0,10,0
11,0,0,2,0,0,0,13,0
19,0,0,0,0,0,0,19,0
24,3,0,0,0,0,0,27,0
2,0,0,0,0,0,0,2,0
24,0,0,6,0,0,0,30,0
16,0,0,1,0,0,2,19,0
4,0,0,0,0,0,1,5,1
9,0,0,0,0,0,0,9,0
26,0,0,3,0,0,1,30,1
21,0,0,0,0,0,3,24,0
2,0,0,8,0,0,0,10,0
15,0,0,0,0,0,0,15,0
207,14,0,16,0,6,7,250,0
55,0,0,0,0,0,0,55,0
2,0,0,0,0,0,0,2,0
24,0,0,0,0,0,0,24,0
10,0,1,0,0,0,0,11,0
6,0,0,0,0,0,0,6,0
32,0,0,0,0,0,0,32,0
9,0,0,0,0,0,0,9,0
12,0,0,0,0,0,0,12,0
21,0,0,0,0,0,0,21,0
18,0,0,0,0,0,0,18,0
8,0,0,0,0,0,0,8,0
1,0,0,0,0,0,0,1,0
63,0,0,0,0,0,0,63,0
116,10,1,2,0,0,4,133,0
15,0,0,0,0,0,0,15,0
67,6,0,0,0,0,0,73,0
10,0,0,0,0,0,0,10,0
5,4,0,0,0,0,0,9,0
31,1,0,0,0,0,0,32,0
12,1,0,0,0,0,0,13,1
59,0,0,0,0,0,0,59,0
58,1,0,0,0,0,1,60,2
121,6,0,4,0,0,0,131,0
172,8,0,4,0,0,0,184,0
25,0,0,0,0,0,1,26,0
9,0,0,5,0,0,0,14,0
5,0,0,0,0,0,0,5,0
28,0,0,0,0,0,0,28,0
0,0,0,4,0,0,0,4,0
16,0,0,0,0,0,0,16,0
20,0,0,0,0,0,1,21,0
34,0,0,0,0,0,0,34,0
2,0,0,0,0,0,0,2,0
71,0,0,0,0,0,0,71,0
190,0,1,2,0,0,5,198,0
86,0,0,2,0,0,0,88,0
88,0,0,0,0,0,0,88,0
52,0,0,0,0,0,0,52,0
33,0,0,0,0,0,0,33,0
11,0,0,0,0,1,1,13,0
2,0,0,0,0,0,0,2,0
2,0,0,0,0,0,0,2,0
16,0,0,0,0,0,0,16,0
31,0,0,0,0,0,0,31,0
16,0,0,0,0,0,0,16,0
10,0,0,0,0,0,0,10,0
1,0,0,0,0,0,0,1,0
34,1,0,0,0,0,0,35,0
70,3,0,4,0,2,1,80,0
4,0,0,0,0,0,0,4,0
15,0,0,0,0,0,0,15,0
127,4,0,0,0,0,4,135,0
40,4,0,1,0,0,5,50,0
20,1,0,0,0,0,0,21,0
320,2,0,3,0,2,6,333,0
168,3,0,1,0,0,4,176,0
2,0,0,0,0,0,0,2,0
103,4,0,1,0,0,0,108,0
215,0,0,2,0,0,1,218,0
7,0,0,0,0,0,0,7,0
50,2,0,0,0,0,0,52,0
135,2,3,8,0,0,4,152,0
53,0,0,0,0,0,1,54,0
7,0,0,0,0,0,0,7,0
17,0,0,0,0,0,1,18,0
17,0,0,4,0,0,0,21,0
15,1,0,0,0,0,0,16,0
41,0,0,0,0,0,0,41,0
71,0,0,0,0,0,1,72,0
143,0,1,2,0,0,2,148,0
7,0,0,0,0,0,0,7,0
60,0,0,0,0,0,0,60,0
66,0,0,1,0,0,0,67,0
143,1,0,0,0,1,0,145,0
51,0,0,2,0,0,0,53,0
62,0,0,0,0,0,4,66,0
65,0,0,3,0,0,0,68,0
29,4,0,0,0,0,4,37,0
13,0,0,0,0,0,0,13,0
86,3,0,0,0,0,0,89,0
33,0,0,1,0,1,0,35,0
211,0,0,1,0,1,1,214,0
39,0,0,0,0,0,0,39,0
22,8,0,0,0,0,0,30,0
12,0,0,0,0,0,0,12,0
22,0,0,0,0,0,0,22,0
16,0,0,0,0,0,0,16,0
9,7,0,0,0,0,0,16,0
12,0,0,0,0,0,0,12,0
164,1,0,0,0,0,4,169,0
90,3,0,0,0,0,0,93,0
11,0,0,0,0,0,0,11,0
1,0,0,0,0,0,0,1,0
4,0,0,0,0,0,0,4,0
3,0,0,0,0,0,0,3,0
2,0,0,0,0,0,0,2,0
2,0,0,0,0,0,0,2,0
4,0,0,0,0,0,0,4,0
10,0,0,3,0,0,0,13,0
2,0,0,0,0,0,0,2,0
565,5,0,6,0,1,9,586,0
89,1,0,0,0,0,0,90,0
16,0,0,0,0,0,0,16,0
67,3,0,0,0,0,3,73,0
148,3,0,1,0,0,4,156,0
17,0,0,0,0,0,0,17,0
361,9,1,1,0,0,17,389,0
142,1,1,3,0,0,4,151,0
54,1,0,0,0,0,4,59,0
65,6,0,2,0,0,2,75,0
216,7,0,0,0,0,0,223,0
204,6,0,7,0,0,5,222,0
10,0,0,0,0,0,0,10,0
23,0,0,4,0,0,0,27,0
18,0,0,0,0,0,1,19,1
3,0,0,0,0,0,1,4,0
36,0,0,0,0,0,0,36,0
9,0,0,0,0,0,0,9,0
25,0,0,0,0,0,0,25,0
4,0,0,0,0,0,0,4,0
22,3,0,0,0,0,0,25,0
25,0,0,0,0,0,0,25,0
10,0,0,0,0,0,0,10,0
76,8,0,0,0,0,0,84,0
11,0,0,0,0,0,0,11,0
78,0,0,0,0,0,1,79,0
9,0,0,0,0,0,0,9,0
124,0,0,2,0,0,4,130,0
39,0,0,0,0,0,0,39,0
9,0,0,0,0,0,0,9,0
359,5,1,2,0,0,4,371,0
68,1,0,4,0,0,2,75,0
37,10,0,0,0,4,0,51,0
28,0,0,0,0,0,0,28,0
114,4,0,1,0,0,0,119,0
16,0,0,1,0,0,1,18,0
25,0,0,0,0,0,1,26,0
133,0,0,2,0,0,0,135,0
0,1,0,0,3,0,0,4,0
5,0,0,0,0,0,0,5,0
9,0,0,0,0,0,0,9,0
3,0,0,0,0,0,0,3,0
2,0,0,0,0,0,0,2,0
2,0,0,0,0,0,0,2,0
2,0,0,0,0,0,0,2,0
24,0,0,0,0,0,0,24,0
1,0,0,0,0,0,0,1,0
31,0,0,0,0,1,0,32,0
2,0,0,0,0,0,0,2,0
9,0,0,0,0,0,0,9,0
39,0,0,1,0,0,0,40,0
21,1,0,1,0,0,0,23,1
6,0,0,0,0,0,0,6,0
48,0,0,6,0,0,0,54,0
38,0,0,0,0,0,0,38,0
21,0,0,0,0,0,0,21,0
15,0,0,0,0,0,0,15,0
7,0,0,0,0,0,0,7,0
45,0,0,2,0,0,4,51,0
22,0,0,1,0,0,0,23,0
59,0,0,0,0,0,0,59,0
72,12,0,0,0,0,0,84,0
42,6,0,5,0,0,0,53,0
46,5,0,0,0,2,0,53,0
8,0,0,0,0,0,0,8,0
3,0,0,0,0,0,0,3,0
27,0,0,0,0,0,1,28,0
6,0,0,0,0,0,0,6,0
39,0,0,0,0,0,0,39,0
11,0,0,0,0,0,0,11,0
7,0,0,0,0,0,0,7,0
7,0,0,0,0,0,0,7,0
29,0,0,0,0,0,0,29,0
67,0,0,0,0,2,2,71,0
18,0,0,0,0,0,0,18,0
2,0,0,0,0,0,0,2,0
4,0,0,0,0,0,0,4,0
69,25,0,1,0,9,0,104,1
55,2,0,6,0,0,0,63,0
65,0,3,0,0,0,1,69,1
54,0,0,0,0,0,0,54,0
45,1,0,3,0,1,0,50,0
1,0,0,0,0,0,0,1,1
15,0,0,0,0,0,0,15,0
19,0,0,0,0,0,0,19,0
19,0,0,0,0,0,0,19,0
3,0,0,0,0,0,0,3,0
2,0,0,0,0,0,0,2,0
2,0,0,0,0,0,0,2,0
13,0,0,0,0,0,0,13,0
32,0,0,0,0,0,0,32,0
81,0,3,0,0,0,0,84,0
54,2,0,0,0,1,0,57,0
94,0,0,5,0,0,0,99,0
2,0,0,0,0,0,0,2,0
54,0,0,0,0,0,0,54,0
5,0,0,0,0,0,0,5,0
554,52,4,13,0,4,26,653,0
68,8,4,6,0,1,5,92,1
167,6,0,2,0,0,0,175,0
123,12,0,1,0,0,7,143,0
56,0,0,0,0,0,13,69,0
68,9,0,0,0,0,4,81,0
55,1,1,3,0,0,2,62,1
63,2,0,0,0,1,0,66,0
151,6,0,0,0,2,3,162,0
55,1,0,4,0,0,6,66,0
58,11,0,1,0,0,2,72,0
152,21,10,1,0,14,7,205,0
41,14,0,5,0,0,8,68,0
81,7,0,0,0,0,6,94,0
34,1,0,2,0,0,1,38,0
29,5,0,0,0,0,3,37,0
39,2,0,0,0,0,0,41,0
63,10,0,0,0,3,1,77,0
136,7,0,0,0,8,8,159,0
12,0,0,0,0,0,0,12,0
51,2,0,0,0,0,0,53,0
12,0,0,0,0,0,0,12,0
44,4,0,0,0,3,3,54,0
50,1,0,1,0,2,0,54,1
38,2,0,7,0,3,3,53,0
50,3,0,10,0,0,2,65,0
22,0,0,0,0,0,0,22,0
7,0,0,0,0,0,0,7,0
23,1,0,0,0,0,3,27,0
86,1,1,3,0,5,1,97,1
14,0,0,0,0,0,0,14,0
91,0,0,0,0,0,0,91,0
23,0,0,0,0,3,0,26,0
27,4,0,4,0,0,5,40,0
8,0,0,0,0,0,0,8,0
16,0,0,0,0,0,0,16,0
19,1,0,0,0,0,1,21,0
63,0,0,0,0,0,4,67,0
144,0,0,0,0,0,0,144,0
40,1,0,0,0,1,0,42,0
45,0,0,0,0,0,0,45,0
107,0,0,1,0,0,0,108,0
35,7,0,0,0,1,5,48,0
121,4,0,9,0,0,0,134,0
23,16,0,1,0,1,0,41,0
45,2,0,0,0,0,1,48,0
249,22,2,7,0,0,8,288,0
65,5,0,5,0,0,0,75,0
100,0,0,6,0,2,5,113,0
87,2,0,0,0,0,0,89,0
80,0,0,2,0,5,0,87,0
84,0,0,5,0,0,5,94,0
122,8,0,0,0,0,1,131,0
94,0,0,0,0,0,0,94,0
71,0,0,2,0,0,1,74,0
185,9,0,5,0,0,3,202,0
7,0,0,0,0,0,0,7,0
41,0,0,0,0,0,0,41,0
12,0,0,0,0,0,0,12,0
42,13,0,0,0,0,0,55,0
53,0,0,4,0,0,5,62,0
14,0,0,0,0,0,2,16,0
63,8,0,0,0,0,4,75,0
62,2,0,1,0,0,0,65,0
114,1,0,7,0,2,10,134,1
34,0,0,0,0,0,0,34,0
1,0,0,0,0,0,0,1,0
0,0,0,0,0,6,0,6,0
5,0,0,0,0,0,0,5,0
25,0,0,0,2,0,0,27,0
59,0,0,0,0,0,0,59,0
341,15,1,1,1,0,15,374,0
127,2,0,1,0,0,8,138,0
13,0,0,0,0,0,0,13,0
20,0,0,3,0,0,1,24,0
3,0,0,0,0,0,0,3,0
11,0,0,0,0,0,1,12,0
82,0,0,0,0,0,0,82,0
71,0,0,0,0,0,1,72,1
32,0,0,0,0,0,0,32,0
11,0,0,0,0,0,0,11,0
36,0,1,0,0,0,1,38,0
32,0,0,0,0,0,1,33,0
2,0,0,0,0,0,0,2,0
114,0,0,0,0,0,1,115,0
16,0,0,0,0,0,0,16,0
15,0,0,0,0,0,0,15,0
32,0,0,0,0,0,0,32,0
29,0,0,0,0,0,0,29,0
12,0,0,0,0,0,0,12,0
12,0,0,0,0,0,1,13,1
50,0,0,0,0,0,0,50,0
12,0,0,0,0,0,0,12,0
61,0,0,0,0,0,0,61,0
49,0,0,0,0,0,0,49,0
54,0,0,0,0,0,1,55,0
95,0,0,0,0,0,0,95,0
39,0,0,0,0,0,0,39,0
29,2,0,0,0,0,1,32,0
88,9,0,0,0,0,3,100,0
75,0,0,0,0,0,0,75,0
41,0,0,1,0,0,0,42,1
194,3,0,0,0,3,8,208,0
33,0,0,0,0,0,0,33,0
15,0,0,0,0,0,0,15,0
189,1,0,0,0,13,0,203,0
26,0,0,0,0,0,1,27,1
31,2,1,0,0,0,0,34,0
55,0,0,0,0,0,0,55,0
118,0,1,0,0,0,0,119,1
12,0,0,0,0,0,0,12,0
17,0,0,0,0,0,0,17,0
56,0,1,0,0,0,0,57,0
43,0,0,0,0,0,0,43,0
57,2,0,0,0,0,3,62,0
53,0,1,0,0,0,0,54,0
13,0,0,0,0,0,0,13,0
31,0,0,0,0,0,0,31,0
30,0,0,0,0,0,0,30,0
71,2,0,0,0,0,0,73,0
41,1,0,3,0,0,0,45,0
50,0,0,0,0,0,0,50,0
7,0,0,0,0,0,0,7,0
49,2,0,0,0,0,0,51,0
253,0,0,5,0,0,4,262,0
17,0,0,0,0,0,1,18,0
13,0,0,0,0,0,1,14,0
46,0,0,0,0,0,0,46,0
27,0,0,0,0,0,0,27,0
26,0,0,0,0,0,0,26,0
13,0,0,0,0,0,5,18,0
48,0,0,0,0,0,0,48,0
30,0,0,0,0,0,0,30,0
12,0,0,0,0,0,0,12,0
58,2,0,0,0,0,0,60,0
2,0,0,0,0,0,0,2,0
51,1,0,0,0,0,0,52,1
23,0,0,0,0,0,0,23,0
15,0,0,0,0,0,0,15,0
20,0,0,0,1,0,0,21,0
5,0,0,0,0,0,0,5,0
6,0,0,0,0,0,0,6,0
17,0,0,0,0,0,0,17,0
40,0,1,1,0,0,3,45,0
14,0,0,0,0,0,0,14,0
0,0,0,4,0,0,0,4,0
0,1,0,0,0,0,0,1,0
4,0,0,0,0,0,0,4,0
28,0,0,0,0,0,0,28,0
19,0,0,1,0,0,0,20,0
20,0,0,0,0,0,0,20,0
2,0,0,0,0,0,0,2,0
6,0,0,0,0,0,0,6,0
18,0,0,1,0,0,1,20,0
28,0,0,1,0,0,5,34,0
5,0,0,0,0,0,0,5,0
19,0,0,0,0,0,0,19,0
5,0,1,0,0,0,0,6,0
22,0,0,0,0,0,0,22,0
8,1,0,0,0,0,0,9,0
22,0,0,0,0,0,0,22,0
6,0,0,0,0,0,0,6,0
16,0,0,0,0,0,0,16,0
7,0,0,0,0,0,0,7,0
9,0,0,0,0,0,0,9,0
8,1,0,0,0,0,1,10,1
14,0,0,0,0,0,0,14,0
5,0,0,0,0,0,0,5,0
2,0,0,0,0,0,0,2,0
6,0,0,0,0,0,0,6,0
4,0,0,0,0,0,0,4,0
7,0,2,0,0,0,0,9,0
9,0,0,0,0,0,0,9,0
7,0,0,0,0,0,0,7,0
3,0,0,0,0,0,0,3,0
21,0,0,0,0,0,0,21,0
5,0,0,0,0,0,0,5,0
10,0,0,0,0,0,0,10,0
2,0,0,0,0,0,0,2,0
8,0,0,0,0,0,0,8,0
12,0,0,0,0,0,0,12,0
5,0,0,0,0,0,0,5,0
1,0,0,0,0,0,1,2,0
88,0,0,0,0,3,1,92,0
64,0,0,0,0,0,0,64,0
244,0,1,2,0,2,13,262,0
3,0,0,0,0,0,0,3,0
41,0,0,0,0,0,4,45,0
160,0,0,0,0,1,1,162,0
63,3,0,3,0,0,1,70,0
101,0,0,0,0,0,0,101,0
7,0,0,0,0,0,0,7,0
4,0,2,0,0,0,0,6,0
60,1,0,0,0,0,0,61,0
28,2,0,0,0,0,0,30,0
269,0,0,0,0,0,2,271,0
10,0,0,0,0,0,0,10,0
7,0,0,0,0,0,0,7,0
9,0,0,0,0,0,0,9,0
26,0,0,0,0,0,0,26,0
71,0,0,0,0,0,0,71,0
28,2,0,0,0,0,0,30,0
53,0,0,1,0,0,0,54,0
8,0,0,0,0,0,0,8,0
287,2,1,0,0,0,10,300,0
7,0,0,0,0,0,0,7,0
8,0,0,0,0,0,0,8,0
2,0,0,0,0,0,0,2,0
0,0,0,0,0,4,0,4,0
20,0,0,3,0,0,0,23,0
0,4,0,0,0,0,0,4,0
9,0,0,0,0,0,0,9,0
16,0,0,0,0,0,0,16,0
2,0,0,0,0,0,2,4,0
6,0,0,0,0,0,0,6,0
57,0,0,0,0,1,0,58,0
59,0,0,1,0,1,2,63,1
219,1,0,2,0,4,0,226,0
34,0,0,0,0,0,1,35,0
7,0,0,0,0,0,0,7,0
43,0,0,0,0,0,0,43,0
10,0,0,0,0,0,0,10,0
9,0,0,0,0,0,0,9,0
40,7,2,0,0,0,0,49,0
4,0,0,0,0,0,0,4,0
548,8,0,0,0,1,5,562,0
43,0,0,0,0,0,0,43,0
57,0,0,0,0,0,1,58,0
27,1,0,0,0,0,0,28,0
7,0,0,0,0,0,0,7,0
25,0,0,0,0,0,0,25,0
114,1,0,0,0,0,0,115,0
4,0,0,0,0,0,0,4,0
66,0,0,1,0,1,0,68,0
17,1,0,0,0,0,0,18,1
34,0,1,0,0,0,0,35,0
4,6,0,0,0,0,0,10,0
94,70,0,12,0,3,0,179,0
62,39,0,6,0,1,8,116,0
102,57,0,1,0,15,12,187,0
59,57,0,5,0,0,2,123,0
53,31,0,7,0,6,8,105,0
42,35,0,5,0,2,5,89,0
66,63,0,3,0,7,4,143,0
93,111,6,0,0,64,12,286,0
75,51,1,8,0,20,10,165,0
33,41,0,7,1,13,1,96,0
28,0,0,0,0,0,0,28,0
200,6,2,4,0,1,6,219,0
182,0,0,0,0,0,5,187,0
41,2,0,0,0,0,0,43,0
131,0,0,0,0,0,5,136,0
4,0,0,0,0,0,0,4,0
145,5,0,3,0,1,3,157,1
403,44,0,19,0,0,13,479,0
25,4,0,0,0,0,0,29,0
74,35,0,2,0,0,8,119,0
3,0,0,0,0,0,1,4,0
14,3,0,0,0,0,0,17,0
45,4,0,4,0,0,0,53,0
56,11,0,0,0,3,0,70,0
44,0,0,8,0,0,0,52,0
363,56,4,5,0,0,16,444,0
28,4,0,0,0,0,0,32,0
682,132,0,26,0,7,52,899,0
79,0,0,0,0,0,2,81,0
188,46,0,15,0,8,6,263,0
31,11,0,0,0,1,2,45,0
6,0,0,0,0,0,0,6,0
48,4,0,1,0,0,0,53,1
8,0,0,0,0,0,0,8,0
132,20,0,2,0,1,0,155,0
95,6,0,2,0,4,0,107,0
6,7,0,0,0,0,0,13,0
14,3,0,4,0,0,0,21,0
14,0,0,0,0,0,1,15,0
338,69,2,17,0,0,20,446,0
6,0,0,0,0,0,0,6,0
6,4,0,0,0,0,0,10,0
43,8,0,4,0,0,1,56,0
24,40,0,0,0,1,6,71,0
55,4,0,8,0,0,4,71,0
45,5,0,1,0,0,0,51,1
178,35,0,21,0,0,4,238,0
29,8,0,0,0,0,0,37,0
299,37,1,26,0,0,16,379,0
5,0,0,0,0,0,0,5,0
2,0,0,0,0,0,0,2,0
67,16,0,14,0,1,2,100,0
2,0,0,1,0,0,0,3,0
36,0,0,0,0,0,0,36,0
31,0,0,0,0,0,0,31,0
39,8,0,1,0,1,1,50,0
51,0,0,0,0,5,1,57,0
21,16,0,0,0,0,0,37,0
23,158,0,2,0,0,8,191,0
8,28,0,0,0,0,0,36,0
127,24,0,27,0,0,7,185,0
182,54,0,9,0,3,6,254,0
2,22,0,0,0,0,1,25,1
1,0,0,0,0,0,1,2,0
6,4,0,0,0,0,0,10,0
41,174,3,0,0,10,2,230,0
1,48,0,0,0,0,1,50,1
22,0,0,0,0,0,0,22,0
104,84,6,3,0,9,10,216,0
36,40,0,0,0,0,11,87,0
155,248,0,5,0,8,18,434,0
10,11,0,0,0,0,2,23,0
20,6,0,0,0,0,0,26,0
35,16,0,0,1,0,2,54,0
8,2,0,0,0,0,0,10,0
10,7,0,0,0,0,0,17,0
382,299,0,19,0,25,37,762,0
59,52,0,4,0,0,2,117,0
66,37,0,1,0,1,7,112,0
3,2,0,0,0,0,3,8,0
4,0,0,0,0,1,3,8,0
16,20,0,0,0,0,0,36,0
4,4,0,0,0,0,0,8,0
23,10,0,0,0,0,1,34,0
36,21,5,0,0,13,3,78,0
18,6,0,5,0,0,0,29,0
13,12,0,3,0,0,0,28,0
131,93,0,0,0,5,8,237,0
12,24,0,0,0,0,0,36,0
8,9,0,0,0,0,0,17,0
28,18,0,5,0,0,1,52,0
9,4,0,0,0,0,3,16,0
119,63,0,0,0,0,11,193,0
143,92,1,1,0,13,9,259,1
41,26,0,0,0,8,3,78,0
38,9,0,0,0,4,0,51,0
0,13,0,0,0,5,0,18,0
6,0,0,0,0,0,0,6,0
26,8,0,0,0,1,1,36,0
10,25,0,0,0,0,0,35,0
3,0,0,0,0,0,1,4,1
69,30,0,0,0,5,0,104,0
46,35,0,0,0,0,5,86,0
13,10,0,0,0,5,0,28,0
17,1,0,0,0,0,3,21,0
19,5,0,0,0,0,0,24,0
24,0,0,0,0,0,6,30,0
68,14,0,0,0,2,13,97,0
0,0,0,5,0,0,0,5,0
36,25,0,0,0,0,0,61,0
3,0,0,0,0,0,0,3,0
206,99,0,3,0,12,8,328,0
60,8,0,0,0,0,0,68,0
93,25,0,0,0,0,8,126,0
12,2,0,0,0,0,0,14,0
88,39,0,3,0,6,3,139,0
41,17,0,4,0,0,0,62,0
42,4,0,1,0,0,0,47,0
38,0,0,0,0,0,0,38,0
52,22,0,2,0,1,6,83,1
169,41,0,0,0,0,10,220,0
77,18,0,0,0,3,3,101,0
21,18,0,0,0,0,0,39,0
83,16,0,0,0,0,3,102,0
281,69,0,9,0,5,12,376,0
23,4,0,0,0,2,0,29,0
28,2,0,0,0,0,4,34,0
424,97,3,26,0,10,35,595,0
44,10,0,3,0,5,5,67,0
99,45,0,1,0,1,16,162,0
45,23,2,0,0,0,5,75,0
528,144,1,15,0,0,27,715,1
2,0,0,0,0,0,0,2,0
56,40,0,0,0,0,9,105,0
73,11,0,0,0,0,4,88,0
97,32,0,0,0,7,0,136,0
40,24,1,0,0,0,5,70,0
7,9,0,0,0,0,0,16,0
55,11,0,1,0,0,5,72,0
17,5,0,0,0,0,0,22,0
2,0,0,0,0,0,0,2,0
4,0,0,0,0,0,0,4,0
50,46,1,0,0,13,5,115,0
1,0,0,0,0,0,0,1,1
117,91,0,13,0,2,19,242,0
32,80,0,3,0,0,3,118,0
30,275,0,0,0,0,11,316,0
8,24,0,1,0,0,0,33,0
29,54,0,0,0,0,1,84,0
79,6,1,0,0,9,0,95,0
2,0,0,0,0,0,0,2,0
5,36,0,0,0,0,0,41,0
15,57,0,1,0,7,8,88,0
19,45,0,0,0,1,4,69,1
20,21,0,0,0,0,0,41,0
2,5,0,0,0,0,0,7,0
10,38,0,1,0,0,0,49,0
7,0,0,0,0,0,0,7,0
0,5,0,0,0,0,0,5,0
10,2,0,0,0,0,0,12,0
21,0,0,0,0,0,0,21,0
4,0,0,0,0,0,0,4,0
2,3,0,0,0,0,0,5,0
260,156,0,6,0,2,21,445,0
82,57,0,0,0,1,3,143,0
87,116,0,2,0,0,6,211,0
145,111,1,5,0,1,16,279,0
3,0,0,0,0,0,0,3,0
18,20,0,0,0,0,0,38,0
15,17,0,0,0,1,2,35,0
126,31,0,15,0,1,4,177,0
9,3,2,0,0,0,8,22,0
19,15,0,0,0,0,0,34,0
5,9,0,1,0,0,2,17,0
5,7,0,3,0,0,0,15,0
23,10,0,0,0,0,0,33,0
10,2,0,1,0,0,2,15,0
30,6,0,2,0,0,2,40,0
2,8,0,3,0,0,0,13,0
3,7,0,0,0,0,0,10,0
11,18,0,0,0,0,0,29,0
1,4,0,0,0,1,0,6,1
7,5,0,0,0,0,0,12,0
221,71,0,6,0,13,10,321,0
72,21,0,0,0,0,2,95,0
79,75,0,0,0,3,6,163,0
173,87,0,6,0,4,16,286,0
10,3,0,0,0,0,0,13,0
4,4,0,0,0,0,0,8,0
22,4,0,0,0,0,0,26,0
8,5,0,0,0,0,0,13,0
88,29,0,7,0,0,9,133,0
54,17,0,1,0,0,8,80,1
30,15,0,5,0,1,3,54,0
2,3,0,6,0,0,0,11,0
57,13,0,3,0,1,2,76,0
46,16,0,1,0,3,0,66,0
36,13,0,1,0,0,0,50,0
40,7,0,0,0,0,0,47,0
13,20,0,0,0,4,0,37,0
15,6,0,0,0,0,0,21,0
35,17,0,0,0,0,1,53,0
21,15,1,0,0,7,6,50,0
60,39,0,0,0,0,3,102,0
57,29,0,0,0,1,4,91,0
95,155,0,2,0,24,8,284,0
64,31,0,1,0,3,1,100,1
119,180,0,6,0,21,25,351,0
19,25,0,0,0,0,2,46,0
2,0,0,0,0,0,0,2,0
324,279,3,3,0,25,27,661,0
7,33,0,0,0,1,1,42,1
27,10,0,4,0,0,2,43,0
34,19,0,1,0,0,3,57,0
41,5,0,0,0,5,0,51,0
31,17,0,0,0,0,1,49,1
56,183,0,0,0,9,15,263,0
43,8,0,0,0,0,0,51,0
57,47,0,0,0,1,1,106,1
12,7,0,0,0,0,4,23,0
0,0,0,3,0,0,0,3,0
19,11,0,0,0,0,1,31,0
0,1,1,0,0,4,0,6,0
8,3,0,1,0,3,1,16,1
42,6,0,1,0,3,1,53,0
41,2,0,1,0,0,0,44,0
22,1,0,0,0,1,1,25,0
210,61,0,2,0,2,3,278,0
28,15,2,0,0,0,1,46,0
201,9,0,0,0,1,2,213,0
17,0,0,1,0,0,0,18,0
36,2,0,0,0,0,0,38,0
8,0,0,0,0,0,0,8,0
28,0,1,0,0,0,1,30,0
46,8,0,3,0,0,0,57,0
3,0,0,0,0,0,0,3,0
2,0,0,0,0,0,0,2,0
9,3,0,1,0,0,0,13,0
26,15,0,0,0,1,2,44,0
258,84,0,18,0,3,9,372,0
26,2,0,0,0,0,0,28,0
76,11,1,10,0,0,0,98,0
0,1,0,0,0,0,0,1,0
21,0,0,0,0,0,3,24,0
3,1,0,0,0,0,2,6,1
2,0,0,0,0,0,0,2,0
0,0,0,1,0,0,0,1,0
13,0,0,0,0,0,0,13,0
27,0,0,0,0,1,0,28,0
7,0,0,0,0,0,0,7,0
4,0,0,0,0,0,0,4,0
4,0,0,0,0,0,0,4,0
4,0,0,0,0,0,0,4,0
2,0,0,0,0,0,0,2,0
12,0,0,0,0,0,0,12,0
20,0,0,0,0,0,0,20,0
55,4,1,0,0,0,0,60,1
70,0,0,1,0,0,0,71,0
16,0,0,0,0,0,0,16,0
2,0,0,0,0,0,0,2,0
5,0,0,0,0,0,0,5,0
73,9,0,0,0,2,12,96,0
279,30,1,1,0,2,11,324,0
98,10,3,1,0,8,4,124,0
42,9,0,0,0,2,5,58,0
28,3,0,0,0,0,6,37,0
49,3,0,0,4,0,6,62,0
13,0,0,0,0,0,0,13,0
52,2,0,1,0,2,4,61,0
75,10,0,0,0,0,6,91,0
4,0,0,0,0,0,0,4,0
165,30,0,0,0,3,22,220,0
74,41,0,0,0,0,12,127,0
128,10,0,1,0,1,2,142,1
4,0,0,0,0,0,0,4,0
5,0,0,0,0,0,0,5,0
71,19,0,2,0,1,7,100,0
94,31,1,0,0,1,10,137,0
76,27,0,2,0,0,1,106,1
119,58,0,6,0,8,10,201,0
128,43,0,0,0,12,6,189,0
29,10,0,1,0,0,5,45,0
17,0,0,0,0,0,0,17,0
9,0,0,0,0,0,0,9,0
11,0,0,0,0,0,0,11,0
138,21,0,0,0,3,8,170,0
40,1,0,0,0,0,0,41,1
46,5,0,0,0,0,0,51,0
54,4,0,0,0,0,0,58,0
39,8,0,1,0,0,3,51,0
31,18,0,0,0,0,3,52,0
7,0,0,0,0,0,0,7,0
244,0,0,42,0,1,0,287,0
58,0,0,15,0,0,0,73,0
43,4,0,8,0,0,0,55,0
8,2,0,23,0,5,0,38,0
32,0,0,28,0,0,0,60,0
25,0,0,33,0,4,0,62,0
9,0,0,9,0,0,5,23,0
13,0,0,4,0,0,0,17,0
41,0,0,26,0,0,0,67,0
58,0,0,35,0,0,2,95,0
107,0,0,45,0,2,5,159,0
21,0,0,20,0,0,0,41,0
92,0,0,41,0,1,2,136,0
6,0,2,22,0,0,2,32,0
10,0,0,0,0,0,0,10,0
221,5,0,39,0,1,6,272,0
29,0,0,24,0,0,0,53,0
27,0,0,9,0,0,0,36,0
99,3,0,17,0,0,1,120,1
440,8,0,30,0,3,12,493,0
46,0,0,18,0,0,0,64,0
130,1,0,2,0,0,4,137,1
48,0,0,10,0,0,0,58,0
127,0,0,15,0,1,0,143,0
25,0,0,33,0,0,2,60,0
83,0,0,28,0,0,3,114,0
16,0,0,6,0,0,0,22,0
140,0,0,19,0,0,4,163,0
185,4,1,33,0,4,8,235,0
37,0,0,11,0,0,0,48,0
290,12,0,31,0,0,8,341,0
3,0,0,4,0,0,0,7,0
47,0,0,1,0,0,1,49,1
82,0,0,15,0,0,3,100,0
24,0,0,9,0,0,0,33,0
22,3,0,1,0,0,2,28,0
171,0,0,36,0,0,4,211,0
3,0,0,0,0,0,0,3,0
391,0,0,28,0,0,6,425,0
30,1,0,0,0,0,0,31,0
50,0,1,43,0,4,0,98,0
28,0,0,12,0,0,2,42,0
93,2,0,80,0,3,10,188,0
11,0,0,21,0,0,0,32,0
50,0,0,3,0,0,0,53,0
87,3,0,39,0,4,2,135,0
3,0,0,8,0,0,0,11,0
39,0,0,30,0,1,0,70,0
344,5,0,15,0,0,6,370,0
35,0,0,6,0,0,2,43,0
2,0,0,0,0,0,0,2,0
19,0,0,0,0,0,0,19,0
76,0,0,8,0,0,2,86,0
72,0,0,11,5,0,0,88,0
152,5,0,29,0,0,6,192,0
66,4,0,17,0,0,0,87,0
46,0,0,1,0,0,0,47,1
90,10,0,5,0,0,1,106,0
91,3,0,21,0,0,3,118,0
152,0,0,33,1,0,2,188,0
12,0,0,1,0,0,0,13,0
139,0,0,26,0,0,2,167,0
20,0,0,16,0,0,3,39,0
30,0,0,13,0,0,0,43,0
18,0,0,1,0,0,2,21,0
297,4,0,46,0,1,3,351,1
45,4,0,14,0,0,2,65,0
85,4,0,18,0,1,1,109,0
71,0,0,4,0,0,0,75,0
76,5,0,5,0,0,4,90,0
131,3,0,5,0,7,4,150,0
141,2,0,10,0,0,3,156,0
317,5,0,55,0,1,3,381,0
26,0,0,3,0,0,0,29,0
60,0,0,2,0,0,0,62,0
41,0,0,0,0,3,0,44,0
0,0,0,2,0,0,0,2,0
5,0,0,0,0,0,0,5,0
76,16,0,17,0,5,0,114,0
207,0,0,17,0,0,8,232,0
98,0,0,12,0,0,2,112,0
107,1,0,2,0,2,6,118,0
30,0,0,0,0,0,0,30,0
35,0,0,0,0,0,0,35,0
27,0,0,1,0,0,0,28,0
27,0,0,1,0,0,0,28,0
65,0,0,4,0,0,0,69,0
15,0,0,0,0,0,0,15,0
179,0,0,16,0,1,5,201,0
41,6,0,4,0,0,0,51,0
62,0,0,3,0,0,0,65,0
113,0,0,3,0,0,4,120,0
83,0,0,1,0,0,2,86,0
28,0,0,0,0,0,0,28,0
185,0,1,25,0,0,3,214,0
123,0,0,24,0,1,0,148,0
172,3,0,29,0,1,5,210,0
164,0,0,33,0,1,0,198,0
33,0,0,9,0,0,1,43,0
158,0,0,15,0,0,0,173,0
51,0,0,4,0,0,0,55,0
81,0,0,5,0,0,0,86,0
105,0,0,7,0,0,2,114,0
147,0,0,6,0,0,5,158,0
77,1,0,13,0,0,0,91,1
53,1,0,4,0,0,0,58,1
87,1,0,3,0,0,0,91,0
32,0,0,1,0,0,2,35,0
83,0,0,6,0,0,1,90,0
306,0,0,51,0,0,14,371,0
21,0,0,0,0,0,0,21,0
75,0,0,4,0,3,0,82,0
228,8,0,173,0,3,6,418,0
261,11,0,314,0,10,10,606,0
351,0,0,39,0,0,3,393,0
118,0,0,13,0,0,2,133,0
23,0,0,0,0,0,1,24,0
35,0,0,0,0,0,0,35,0
137,1,0,15,0,2,2,157,1
16,0,0,0,0,0,0,16,0
3,0,0,0,0,0,0,3,0
75,0,0,9,0,0,0,84,0
31,0,0,0,0,0,0,31,0
130,2,1,8,0,0,4,145,0
62,0,0,0,0,0,0,62,0
144,2,0,4,0,0,6,156,0
25,0,0,0,0,0,0,25,0
223,4,0,37,1,0,1,266,0
27,0,0,0,0,1,3,31,0
72,14,0,23,0,0,3,112,0
5,0,0,9,0,0,1,15,0
35,1,0,12,0,0,1,49,0
220,7,0,20,0,0,0,247,0
28,0,0,1,0,0,0,29,0
79,0,0,3,0,0,3,85,0
45,1,0,0,0,0,0,46,0
4,0,0,0,0,0,0,4,0
17,0,0,2,0,0,0,19,0
103,15,0,81,0,2,2,203,0
260,6,2,21,0,7,3,299,0
6,0,0,0,0,0,0,6,0
0,0,0,3,0,0,2,5,0
17,0,0,0,0,0,0,17,0
13,0,0,3,0,0,0,16,0
190,0,0,35,0,1,2,228,0
443,5,1,16,0,1,4,470,0
43,10,0,19,0,0,0,72,0
37,0,0,1,0,0,1,39,0
85,0,0,7,0,0,4,96,0
34,0,0,1,0,0,0,35,1
126,6,0,18,0,0,5,155,0
25,1,0,20,0,0,2,48,0
397,16,1,34,0,4,13,465,0
86,3,0,8,0,0,0,97,0
129,16,0,16,0,7,10,178,0
238,11,0,23,0,0,2,274,0
57,0,0,0,0,2,2,61,0
59,0,0,8,0,0,3,70,0
162,9,0,0,0,0,8,179,0
76,8,0,2,0,2,3,91,0
35,5,0,4,0,0,0,44,0
25,0,0,0,0,0,0,25,0
77,0,0,16,0,0,1,94,0
327,9,0,19,0,6,6,367,0
41,0,1,6,0,0,2,50,1
50,0,0,40,0,1,0,91,0
58,0,0,0,0,0,0,58,0
17,0,0,23,0,0,0,40,0
10,0,0,0,0,0,0,10,0
25,0,0,8,0,0,0,33,0
105,0,0,22,0,0,1,128,0
64,2,0,11,0,0,0,77,0
65,2,0,4,0,0,4,75,0
47,0,0,5,0,0,6,58,0
123,1,0,6,0,0,0,130,0
161,6,0,13,0,0,6,186,0
29,0,0,0,0,0,0,29,0
42,0,0,0,0,0,1,43,0
30,8,0,7,0,0,0,45,0
33,0,0,4,0,0,0,37,0
45,0,0,0,0,1,0,46,1
24,0,0,11,0,0,4,39,0
22,0,0,6,0,0,0,28,0
25,10,0,9,0,0,0,44,0
53,0,0,7,0,3,2,65,0
22,0,0,1,0,0,2,25,1
2,0,0,0,0,0,0,2,0
21,0,0,3,0,0,0,24,0
84,0,0,1,0,0,1,86,0
22,0,0,0,0,4,0,26,0
15,0,0,0,0,0,0,15,0
16,0,0,9,0,0,0,25,0
1,0,0,7,0,0,0,8,0
948,27,2,24,0,4,26,1031,0
11,2,0,0,0,4,0,17,0
5,0,0,0,0,6,0,11,0
18,0,0,0,0,0,0,18,0
26,0,0,3,0,0,0,29,0
34,0,0,0,0,0,0,34,0
44,4,0,0,0,1,0,49,0
100,0,0,0,0,0,0,100,0
9,0,0,0,0,0,0,9,0
17,0,0,0,0,1,0,18,0
55,4,2,3,0,1,1,66,0
41,3,0,0,0,0,1,45,0
37,0,0,5,0,0,2,44,0
1,0,0,0,0,0,1,2,2
23,8,0,6,0,0,0,37,0
143,12,0,7,0,6,7,175,0
65,2,0,0,0,0,0,67,0
219,0,1,22,0,1,0,243,0
66,0,0,12,0,0,5,83,0
128,0,0,11,0,0,0,139,0
59,2,0,4,0,0,0,65,0
184,6,0,5,0,0,2,197,0
30,0,0,0,0,0,0,30,0
43,1,0,0,0,0,0,44,0
55,0,0,2,0,0,1,58,0
88,0,0,5,0,0,8,101,0
48,0,0,23,0,2,0,73,0
36,0,0,6,0,0,0,42,0
29,0,0,3,0,0,5,37,0
219,6,0,14,0,0,2,241,0
62,0,0,2,0,0,0,64,0
33,0,0,0,0,0,0,33,0
144,0,0,4,0,1,0,149,0
27,0,0,3,0,0,0,30,0
83,1,0,0,0,0,1,85,1
39,0,0,5,0,0,0,44,0
76,0,0,12,0,0,0,88,0
33,0,0,11,0,0,0,44,0
71,9,0,2,0,0,3,85,0
106,7,0,6,0,6,6,131,0
49,0,0,0,0,0,0,49,0
105,9,0,0,0,1,4,119,0
37,4,0,0,0,0,1,42,1
8,0,0,0,0,0,0,8,0
8,0,0,0,0,0,0,8,0
43,0,0,8,0,0,0,51,0
282,15,0,51,0,7,18,373,0
49,0,0,33,0,0,4,86,0
104,0,0,35,0,1,0,140,0
53,0,0,11,0,0,3,67,0
128,4,0,13,0,0,0,145,0
35,3,2,21,0,0,1,62,0
32,0,0,0,0,0,1,33,1
24,0,0,0,0,1,0,25,1
166,5,0,8,0,0,1,180,0
253,10,0,4,0,0,3,270,0
57,0,1,2,0,0,0,60,0
53,1,1,0,0,0,0,55,1
258,3,0,16,0,11,3,291,0
54,3,0,5,0,0,3,65,0
75,1,0,5,0,0,0,81,1
91,5,0,7,0,0,0,103,0
67,0,0,1,0,0,0,68,0
333,23,0,31,0,5,15,407,0
40,8,0,0,0,0,0,48,0
42,0,0,0,0,0,0,42,0
21,0,0,0,0,0,0,21,0
31,8,0,6,0,0,0,45,0
41,1,1,0,1,1,0,45,2
66,14,0,3,0,10,7,100,0
178,22,3,5,0,1,8,217,1
92,17,0,0,0,1,2,112,0
9,0,0,0,0,0,0,9,0
42,6,0,9,0,0,0,57,0
167,20,0,7,0,1,1,196,2
2,0,0,0,0,0,0,2,0
